After a long and grueling battle against the calamity, you find yourself in the courtyard of Hyrule Castle. The calamity has corrupted this land and its influence can be battled with objects of great power. Find the pearls of the goddesses that have been scattered throughout Hyrule Castle and return them to the statues before your time runs out.

Hyrule Castle
An Interactive Fiction by Joe DeLuca
Release 1 / Serial number 190324 / Inform 7 build 6M62 (I6/v6.33 lib 6/12N) SD

North Side
You can see Gohma here.

>take throne
That's fixed in place.

* * *

After a long and grueling battle against the calamity, you find yourself in the courtyard of Hyrule Castle. The calamity has corrupted this land and its influence can be battled with objects of great power. Find the pearls of the goddesses that have been scattered throughout Hyrule Castle and return them to the statues before your time runs out.

Hyrule Castle
An Interactive Fiction by Joe DeLuca
Release 1 / Serial number 190324 / Inform 7 build 6M62 (I6/v6.33 lib 6/12N) SD

North Side
You can see Gohma here.

>sit on chair
That's not something you can sit down on.

* * *

After a long and grueling battle against the calamity, you find yourself in the courtyard of Hyrule Castle. The calamity has corrupted this land and its influence can be battled with objects of great power. Find the pearls of the goddesses that have been scattered throughout Hyrule Castle and return them to the statues before your time runs out.

Hyrule Castle
An Interactive Fiction by Joe DeLuca
Release 1 / Serial number 190324 / Inform 7 build 6M62 (I6/v6.33 lib 6/12N) SD

North Side
You can see Gohma here.

>sit on desk
You get onto the wooden desk.

On the wooden desk you can see a note and a pen.

>exit desk
I only understood you as far as wanting to exit.

>get off desk
You get off the wooden desk.

Study
You can see a wooden desk (on which are a note and a pen) and a wooden chair (empty) here.

>take chair
Taken.

>drop chair
Dropped.

* * *

After a long and grueling battle against the calamity, you find yourself in the courtyard of Hyrule Castle. The calamity has corrupted this land and its influence can be battled with objects of great power. Find the pearls of the goddesses that have been scattered throughout Hyrule Castle and return them to the statues before your time runs out.

Hyrule Castle
An Interactive Fiction by Joe DeLuca
Release 1 / Serial number 190324 / Inform 7 build 6M62 (I6/v6.33 lib 6/12N) SD

North Side
You can see Gohma here.

>take statue of din
That's fixed in place.

* * *

After a long and grueling battle against the calamity, you find yourself in the courtyard of Hyrule Castle. The calamity has corrupted this land and its influence can be battled with objects of great power. Find the pearls of the goddesses that have been scattered throughout Hyrule Castle and return them to the statues before your time runs out.

Hyrule Castle
An Interactive Fiction by Joe DeLuca
Release 1 / Serial number 190324 / Inform 7 build 6M62 (I6/v6.33 lib 6/12N) SD

North Side
You can see Gohma here.

>wait
Time passes.

You took 3 damage from the calamity. Your current health is 97.

>status
That's not a verb I recognise.

>check health
You can't see any such thing.

>wait
Time passes.

*** Run-time problem P31: Attempt to use a property of the 'nothing' non-object: property calamity

You took 0 damage from the calamity. Your health is 100.

>examine room
You can't see any such thing.

>look
Courtyard
You can see an Armory Door, a Boss Door, a statue of Din, a statue of Farore and a statue of Naryu here.

*** Run-time problem P31: Attempt to use a property of the 'nothing' non-object: property calamity

You took 0 damage from the calamity. Your health is 100.

>wait
Time passes.

*** Run-time problem P31: Attempt to use a property of the 'nothing' non-object: property calamity

You took 0 damage from the calamity. Your health is 100.

* * *

>wait
Time passes.

You took 3 damage from the calamity. Your current health is 97.

>wait
Time passes.

You took 3 damage from the calamity. Your current health is 94.

>wait
Time passes.

its big

* * *

>wait
Time passes.

You took 3 damage from the calamity. Your current health is 94.

>go east
Library
You can see a King Door, a large bookshelf (on which is a blue book (closed)), a plush chair (empty) and a fireplace here.

>go west
Courtyard
You can see an Armory Door, a Boss Door, a statue of Din, a statue of Farore and a statue of Naryu here.

You took 3 damage from the calamity. Your current health is 91.

* * *

>wait
Time passes.

You took 3 damage from the calamity. Your current health is 97.

>g
Time passes.

You took 3 damage from the calamity. Your current health is 94.

>g
Time passes.

You took 3 damage from the calamity. Your current health is 91.

>g
Time passes.

You took 3 damage from the calamity. Your current health is 88.

>g
Time passes.

You took 3 damage from the calamity. Your current health is 85.

>g
Time passes.

You took 3 damage from the calamity. Your current health is 82.

>g
Time passes.

You took 3 damage from the calamity. Your current health is 79.

>g
Time passes.

You took 3 damage from the calamity. Your current health is 76.

>g
Time passes.

You took 3 damage from the calamity. Your current health is 73.

>g
Time passes.

You took 3 damage from the calamity. Your current health is 70.

>g
Time passes.

You took 3 damage from the calamity. Your current health is 67.

>g
Time passes.

You took 3 damage from the calamity. Your current health is 64.

>g
Time passes.

You took 3 damage from the calamity. Your current health is 61.

>g
Time passes.

You took 3 damage from the calamity. Your current health is 58.

>g
Time passes.

You took 3 damage from the calamity. Your current health is 55.

>g
Time passes.

You took 3 damage from the calamity. Your current health is 52.

>g
Time passes.

You took 3 damage from the calamity. Your current health is 49.

>g
Time passes.

You took 3 damage from the calamity. Your current health is 46.

>g
Time passes.

You took 3 damage from the calamity. Your current health is 43.

>g
Time passes.

You took 3 damage from the calamity. Your current health is 40.

>g
Time passes.

You took 3 damage from the calamity. Your current health is 37.

>g
Time passes.

You took 3 damage from the calamity. Your current health is 34.

I beg your pardon?

I beg your pardon?

>g
Time passes.

You took 3 damage from the calamity. Your current health is 31.

>g
Time passes.

You took 3 damage from the calamity. Your current health is 28.

>g
Time passes.

You took 3 damage from the calamity. Your current health is 25.

>g
Time passes.

You took 3 damage from the calamity. Your current health is 22.

>g
Time passes.

You took 3 damage from the calamity. Your current health is 19.

>g
Time passes.

You took 3 damage from the calamity. Your current health is 16.

>g
Time passes.

You took 3 damage from the calamity. Your current health is 13.

>g
Time passes.

You took 3 damage from the calamity. Your current health is 10.

>g
Time passes.

You took 3 damage from the calamity. Your current health is 7.

>g
Time passes.

You took 3 damage from the calamity. Your current health is 4.

>g
Time passes.

You took 3 damage from the calamity. Your current health is 1.

>g
Time passes.

You took 3 damage from the calamity. Your current health is -2.

    *** You have died ***

Would you like to RESTART, RESTORE a saved game, QUIT or UNDO the last command?

* * *

After a long and grueling battle against the calamity, you find yourself in the courtyard of Hyrule Castle. The calamity has corrupted this land and its influence can be battled with objects of great power. Find the pearls of the goddesses that have been scattered throughout Hyrule Castle and return them to the statues before your time runs out.

Hyrule Castle
An Interactive Fiction by Joe DeLuca
Release 1 / Serial number 190324 / Inform 7 build 6M62 (I6/v6.33 lib 6/12N) SD

North Side
You can see Gohma here.

>examine statue of naryu
You see nothing special about the statue of Naryu.

You took 3 damage from the calamity. Your current health is 100.

* * *

After a long and grueling battle against the calamity, you find yourself in the courtyard of Hyrule Castle. The calamity has corrupted this land and its influence can be battled with objects of great power. Find the pearls of the goddesses that have been scattered throughout Hyrule Castle and return them to the statues before your time runs out.

Hyrule Castle
An Interactive Fiction by Joe DeLuca
Release 1 / Serial number 190324 / Inform 7 build 6M62 (I6/v6.33 lib 6/12N) SD

North Side
You can see Gohma here.

>go east
Library
You can see a King Door, a large bookshelf (on which is a blue book (closed)), a plush chair (empty) and a fireplace here.

You took 2 damage from the calamity. Your current health is 98.

>open book
You open the blue book, revealing a king's key.

>take key
Taken.

>open door
It seems to be locked.

>unlock door
(with the king's key)
You unlock the King Door.

>go north
(first opening the King Door)

King's Chamber
You can see a King Door, a king's bed and an extravagent desk (on which is Naryu's Pearl) here.

>take pearl
Taken.

>go south
Library
You can see a King Door, a large bookshelf (on which is a blue book (empty)), a plush chair (empty) and a fireplace here.

>go west
Courtyard
You can see an Armory Door, a Boss Door, a statue of Din, a statue of Farore and a statue of Naryu here.

You took 3 damage from the calamity. Your current health is 97.

>put naryu's pearl on naryu's statue
Blue energy emits from Naryu's Pearl.
1 pearls placed.

You took 2 damage from the calamity. Your current health is 95.

>take naryu's pearl
That's fixed in place.

You took 2 damage from the calamity. Your current health is 93.

* * *

>take key
Taken.

>unlock door
(with the king's key)
You unlock the King Door.

* * *

>go south
Library
You can see a King Door, a large bookshelf (on which is a blue book (empty)), a plush chair (empty) and a fireplace here.

>go south
Study
You can see a wooden desk (on which are a note and a pen) and a wooden chair (empty) here.

>go west
Dining Hall
You can see a Korok Door, a dining table (on which are a bowl of fruit and a knife) and eight chairs (empty) here.

>go north
Guard Chamber
You can see a Lockup Door, a metal chair (empty), a metal table and a keyhook (on which is a guard key) here.

>take key
(the guard key)
Taken.

>unlock lockup door
What do you want to unlock the Lockup Door with?

>guard key
You unlock the Lockup Door.

>go west
(first opening the Lockup Door)

Lockup
You can see a Lockup Door, four cells (closed and empty) and a big cell (closed) (in which is Farore's pearl) here.

>unlock big cell with guard key
You unlock the big cell.

>take pearl
(Farore's pearl)
The big cell isn't open.

>open big cell
You open the big cell.

>take farore's pearl
Taken.

>go west
You can't go that way.

>go east
Guard Chamber
You can see a Lockup Door, a metal chair (empty), a metal table and a keyhook here.

>go east
Courtyard
You can see an Armory Door, a Sanctum Door, a statue of Din, a statue of Farore and a statue of Naryu here.

You took 3 damage from the calamity. Your current health is 97.

>unlock armory door
What do you want to unlock the Armory Door with?

>guard key
You unlock the Armory Door.

You took 3 damage from the calamity. Your current health is 94.

>go south
(first opening the Armory Door)

Armory
You can see an Armory Door, a weapon rack (on which are five swords and two bows) and a chest (closed) here.

>open chest
You open the chest, revealing Din's Pearl.

>take pearl
(Din's Pearl)
Taken.

>inventory
You are carrying: 
Din's Pearl
Farore's pearl
a guard key
Naryu's Pearl
a king's key
(Health: 94)

>go north
Courtyard
You can see an Armory Door, a Sanctum Door, a statue of Din, a statue of Farore and a statue of Naryu here.

You took 3 damage from the calamity. Your current health is 91.

>place pearls
That's not a verb I recognise.

>place din's pearl on din's statue
That's not a verb I recognise.

>put din's pearl on din's statue
Red energy emits from Din's Pearl. Some of the calamity disappeared!
1 pearls placed.

You took 2 damage from the calamity. Your current health is 89.

>put naryu's pearl on naryu's statue
Blue energy emits from Naryu's Pearl.
2 pearls placed.

You took 1 damage from the calamity. Your current health is 88.

>place farore's pearl on farore's statue
That's not a verb I recognise.

>put farore's pearl on farore's statue
Green energy emits from Farore's Pearl.
3 pearls placed.

The Sanctum has opened.

>go north
(first opening the Sanctum Door)

    *** You cleared the calamity from Hyrule Castle! ***

Would you like to RESTART, RESTORE a saved game, QUIT or UNDO the last command?

* * *

>go east
Library
You can see a King Door, a large bookshelf (on which is a blue book (closed)), a plush chair (empty) and a fireplace here.

You took 2 damage from the calamity. Your current health is 98.

>go west
Courtyard
You can see an Armory Door, a Sanctum Door, a statue of Din, a statue of Farore and a statue of Naryu here.

You took 3 damage from the calamity. Your current health is 95.

>inventory
You don't seem to have anything now.
(Health: 95)

You took 3 damage from the calamity. Your current health is 92.

>wait
Time passes.

You took 3 damage from the calamity. Your current health is 89.

>wait
Time passes.

You took 3 damage from the calamity. Your current health is 86.

>wait
Time passes.

You took 3 damage from the calamity. Your current health is 83.

>w
Guard Chamber
You can see a Lockup Door, a metal chair (empty), a metal table and a keyhook (on which is a guard key) here.

You took 2 damage from the calamity. Your current health is 81.

>w
(first opening the Lockup Door)
It seems to be locked.

You took 2 damage from the calamity. Your current health is 79.

>e
Courtyard
You can see an Armory Door, a Sanctum Door, a statue of Din, a statue of Farore and a statue of Naryu here.

You took 3 damage from the calamity. Your current health is 76.

>e
Library
You can see a King Door, a large bookshelf (on which is a blue book (closed)), a plush chair (empty) and a fireplace here.

You took 2 damage from the calamity. Your current health is 74.

>e
You can't go that way.

You took 2 damage from the calamity. Your current health is 72.

>w
Courtyard
You can see an Armory Door, a Sanctum Door, a statue of Din, a statue of Farore and a statue of Naryu here.

You took 3 damage from the calamity. Your current health is 69.

>g
Guard Chamber
You can see a Lockup Door, a metal chair (empty), a metal table and a keyhook (on which is a guard key) here.

You took 2 damage from the calamity. Your current health is 67.

>wait
Time passes.

You took 2 damage from the calamity. Your current health is 65.

>e
Courtyard
You can see an Armory Door, a Sanctum Door, a statue of Din, a statue of Farore and a statue of Naryu here.

You took 3 damage from the calamity. Your current health is 62.

>wait
Time passes.

You took 3 damage from the calamity. Your current health is 59.

>g
Time passes.

You took 3 damage from the calamity. Your current health is 56.

>g
Time passes.

You took 3 damage from the calamity. Your current health is 53.

>g
Time passes.

You took 3 damage from the calamity. Your current health is 50.

>g
Time passes.

You took 3 damage from the calamity. Your current health is 47.

>g
Time passes.

You took 3 damage from the calamity. Your current health is 44.

>g
Time passes.

You took 3 damage from the calamity. Your current health is 41.

>g
Time passes.

You took 3 damage from the calamity. Your current health is 38.

>g
Time passes.

You took 3 damage from the calamity. Your current health is 35.

I beg your pardon?

>g
Time passes.

You took 3 damage from the calamity. Your current health is 32.

>g
Time passes.

You took 3 damage from the calamity. Your current health is 29.

>g
Time passes.

You took 3 damage from the calamity. Your current health is 26.

>g
Time passes.

You took 3 damage from the calamity. Your current health is 23.

I beg your pardon?

>g
Time passes.

You took 3 damage from the calamity. Your current health is 20.

>g
Time passes.

You took 3 damage from the calamity. Your current health is 17.

>g
Time passes.

You took 3 damage from the calamity. Your current health is 14.

>g
Time passes.

You took 3 damage from the calamity. Your current health is 11.

I beg your pardon?

>g
Time passes.

You took 3 damage from the calamity. Your current health is 8.

>g
Time passes.

You took 3 damage from the calamity. Your current health is 5.

>g
Time passes.

You took 3 damage from the calamity. Your current health is 2.

>g
Time passes.

You took 3 damage from the calamity. Your current health is -1.

    *** You have died ***

Would you like to RESTART, RESTORE a saved game, QUIT or UNDO the last command?

* * *

>go east
Library
You can see a King Door, a large bookshelf (on which is a blue book (closed)), a plush chair (empty) and a fireplace here.

You took 2 damage from the calamity. Your current health is 98.

>open blue book
You open the blue book, revealing a king's key.

You took 2 damage from the calamity. Your current health is 96.

>take key
Taken.

You took 2 damage from the calamity. Your current health is 94.

>unlock and open king door
You can't see any such thing.

>unlock king door
(with the king's key)
You unlock the King Door.

You took 2 damage from the calamity. Your current health is 92.

>go north
(first opening the King Door)

King's Chamber
You can see a King Door, a king's bed and an extravagent desk (on which is Naryu's Pearl) here.

You took 1 damage from the calamity. Your current health is 91.

>take pearl
Taken.

You took 1 damage from the calamity. Your current health is 90.

>go south
Library
You can see a King Door, a large bookshelf (on which is a blue book (empty)), a plush chair (empty) and a fireplace here.

You took 2 damage from the calamity. Your current health is 88.

>go east
You can't go that way.

You took 2 damage from the calamity. Your current health is 86.

>put naryu's pearl on naryu's statue
I only understood you as far as wanting to put Naryu's Pearl on Naryu's Pearl.

>go west
Courtyard
You can see an Armory Door, a Sanctum Door, a statue of Din, a statue of Farore and a statue of Naryu here.

You took 3 damage from the calamity. Your current health is 83.

>put naryu's pearl on naryu's statue
Blue energy emits from Naryu's Pearl.
1 pearls placed.

You took 2 damage from the calamity. Your current health is 81.

>go west
Guard Chamber
You can see a Lockup Door, a metal chair (empty), a metal table and a keyhook (on which is a guard key) here.

You took 1 damage from the calamity. Your current health is 80.

>take key
(the guard key)
Taken.

You took 1 damage from the calamity. Your current health is 79.

>go west
(first opening the Lockup Door)
It seems to be locked.

You took 1 damage from the calamity. Your current health is 78.

>unlock door
What do you want to unlock the Lockup Door with?

>guard key
You unlock the Lockup Door.

You took 1 damage from the calamity. Your current health is 77.

>go west
(first opening the Lockup Door)

Lockup
You can see a Lockup Door, four cells (closed and empty) and a big cell (closed) (in which is Farore's pearl) here.

>unlock big cell
What do you want to unlock the big cell with?

>guard key
You unlock the big cell.

>take farore's pearl
The big cell isn't open.

>open big cell
You open the big cell.

>take pearl
Taken.

>go west
You can't go that way.

>go east
Guard Chamber
You can see a Lockup Door, a metal chair (empty), a metal table and a keyhook here.

You took 1 damage from the calamity. Your current health is 76.

>go east
Courtyard
You can see an Armory Door, a Sanctum Door, a statue of Din, a statue of Farore and a statue of Naryu (on which is Naryu's Pearl) here.

You took 2 damage from the calamity. Your current health is 74.

>put farore's pearl on farore's statue
Green energy emits from Farore's Pearl.
2 pearls placed.

You took 1 damage from the calamity. Your current health is 73.

>unlock armory door
What do you want to unlock the Armory Door with?

>guard key
You unlock the Armory Door.

You took 1 damage from the calamity. Your current health is 72.

>go south
(first opening the Armory Door)

Armory
You can see an Armory Door, a weapon rack (on which are five swords and two bows) and a chest (closed) here.

* * *

>open chest
You open the chest, revealing Din's Pearl.

>take pearl
Taken.

>go north
Courtyard
You can see an Armory Door, a Sanctum Door, a statue of Din, a statue of Farore (on which is Farore's pearl) and a statue of Naryu (on which is Naryu's Pearl) here.

You took 1 damage from the calamity. Your current health is 71.

>put din's pearl on din's statue
Red energy emits from Din's Pearl. Some of the calamity disappeared!
3 pearls placed.

The Sanctum has opened.

>go north
(first opening the Sanctum Door)

    *** You cleared the calamity from Hyrule Castle! ***

Would you like to RESTART, RESTORE a saved game, QUIT or UNDO the last command?

>Restart
After a long and grueling battle against the calamity, you find yourself in the courtyard of Hyrule Castle. The calamity has corrupted this land and its influence can be battled with objects of great power. Find the pearls of the goddesses that have been scattered throughout Hyrule Castle and return them to the statues before your time runs out.

Hyrule
An Interactive Fiction by Joe DeLuca
Release 1 / Serial number 190116 / Inform 7 build 6M62 (I6/v6.33 lib 6/12N) SD

Courtyard
You can see an Armory Door, a Sanctum Door, a statue of Din, a statue of Farore and a statue of Naryu here.

>place
That's not a verb I recognise.

>go west
Guard Chamber
You can see a Lockup Door, a metal chair (empty), a metal table and a keyhook (on which is a guard key) here.

You took 2 damage from the calamity. Your current health is 98.

>take key
Taken.

You took 2 damage from the calamity. Your current health is 96.

>go west
(first opening the Lockup Door)
It seems to be locked.

You took 2 damage from the calamity. Your current health is 94.

>undo
Guard Chamber
[Previous turn undone.]

>unlock lockup door
(with the guard key)
You unlock the Lockup Door.

You took 2 damage from the calamity. Your current health is 94.

>go west
(first opening the Lockup Door)

Lockup
You can see a Lockup Door, four cells (closed and empty) and a big cell (closed) (in which is Farore's pearl) here.

>unlock big cell and take farore's pearl
You can't use multiple objects with that verb.

>unlock big cell, take farore's pearl
You can't use multiple objects with that verb.

>unlock big cell
(with the guard key)
You unlock the big cell.

>take farore's pearl
The big cell isn't open.

>undo
Lockup
[Previous turn undone.]

>open big cell
You open the big cell.

* * *

>take pearl
Taken.

>go east
Guard Chamber
You can see a Lockup Door, a metal chair (empty), a metal table and a keyhook here.

You took 2 damage from the calamity. Your current health is 92.

>go east
Courtyard
You can see an Armory Door, a Sanctum Door, a statue of Din, a statue of Farore and a statue of Naryu here.

You took 3 damage from the calamity. Your current health is 89.

>unlock armory door
What do you want to unlock the Armory Door with?

>guard key
You unlock the Armory Door.

You took 3 damage from the calamity. Your current health is 86.

>go south
(first opening the Armory Door)

Armory
You can see an Armory Door, a weapon rack (on which are five swords and two bows) and a chest (closed) here.

You took 2 damage from the calamity. Your current health is 84.

>open chest
You open the chest, revealing Din's Pearl.

You took 2 damage from the calamity. Your current health is 82.

>take pearl
(Din's Pearl)
Taken.

You took 2 damage from the calamity. Your current health is 80.

>go north
Courtyard
You can see an Armory Door, a Sanctum Door, a statue of Din, a statue of Farore and a statue of Naryu here.

You took 3 damage from the calamity. Your current health is 77.

>go east
Library
You can see a King Door, a large bookshelf (on which is a blue book (closed)), a plush chair (empty) and a fireplace here.

You took 2 damage from the calamity. Your current health is 75.

>open book
You open the blue book, revealing a king's key.

You took 2 damage from the calamity. Your current health is 73.

>take key
(the king's key)
Taken.

You took 2 damage from the calamity. Your current health is 71.

>unlock king door
What do you want to unlock the King Door with?

>king's key
You unlock the King Door.

You took 2 damage from the calamity. Your current health is 69.

>go north
(first opening the King Door)

King's Chamber
You can see a King Door, a king's bed and an extravagent desk (on which is Naryu's Pearl) here.

You took 1 damage from the calamity. Your current health is 68.

>take pearl
(Naryu's Pearl)
Taken.

You took 1 damage from the calamity. Your current health is 67.

>go south
Library
You can see a King Door, a large bookshelf (on which is a blue book (empty)), a plush chair (empty) and a fireplace here.

You took 2 damage from the calamity. Your current health is 65.

>go west
Courtyard
You can see an Armory Door, a Sanctum Door, a statue of Din, a statue of Farore and a statue of Naryu here.

You took 3 damage from the calamity. Your current health is 62.

>put naryu's pearl on naryu's statue
Blue energy emits from Naryu's Pearl.
1 pearls placed.

You took 2 damage from the calamity. Your current health is 60.

>put din's pearl on din's statue
Red energy emits from Din's Pearl. Some of the calamity disappeared!
2 pearls placed.

You took 1 damage from the calamity. Your current health is 59.

>put farore's pearl on farore's statue
Green energy emits from Farore's Pearl.
3 pearls placed.

The Sanctum has opened.

>wait
Time passes.

The Sanctum has opened.

>go north
(first opening the Sanctum Door)

    *** You cleared the calamity from Hyrule Castle! ***

Would you like to RESTART, RESTORE a saved game, QUIT or UNDO the last command?

* * *

After a long and grueling battle against the calamity, you find yourself in the courtyard of Hyrule Castle. The calamity has corrupted this land and its influence can be battled with objects of great power. Find the pearls of the goddesses that have been scattered throughout Hyrule Castle and return them to the statues before your time runs out.

Hyrule Castle
An Interactive Fiction by Joe DeLuca
Release 1 / Serial number 190324 / Inform 7 build 6M62 (I6/v6.33 lib 6/12N) SD

North Side
You can see Gohma here.

>help
> Introduction to Hyrule Castle
   Instructions for Play
   Attacking
   Placing
   Eating

>HELP
That's not a verb I recognise.

* * *

>help
> Introduction to Hyrule Castle
   Instructions for Play
   Attacking
   Placing
   Eating

   Introduction to Hyrule
 > Instructions for Play
   Attacking
   Placing
   Eating
   Introduction to Hyrule
 > Instructions for Play
   Attacking
   Placing
   Eating

   Introduction to Hyrule
   Instructions for Play
 > Attacking
   Placing
   Eating
   Introduction to Hyrule
   Instructions for Play
 > Attacking
   Placing
   Eating

   Introduction to Hyrule
   Instructions for Play
   Attacking
 > Placing
   Eating
   Introduction to Hyrule
   Instructions for Play
   Attacking
 > Placing
   Eating

 > Introduction to Hyrule
   Instructions for Play
 > Introduction to Hyrule
   Instructions for Play

   Introduction to Hyrule
 > Instructions for Play
   Introduction to Hyrule
 > Instructions for Play

 > About Interactive Fiction
   What to do with >
   Getting Started
   Rooms and Travel
   Objects
   Controlling the Game
   How the World is Assembled
   If You Get Stuck

   About Interactive Fiction
 > What to do with >
   Getting Started
   Rooms and Travel
   Objects
   Controlling the Game
   How the World is Assembled
   If You Get Stuck
   About Interactive Fiction
 > What to do with >
   Getting Started
   Rooms and Travel
   Objects
   Controlling the Game
   How the World is Assembled
   If You Get Stuck

   About Interactive Fiction
   What to do with >
 > Getting Started
   Rooms and Travel
   Objects
   Controlling the Game
   How the World is Assembled
   If You Get Stuck
   About Interactive Fiction
   What to do with >
 > Getting Started
   Rooms and Travel
   Objects
   Controlling the Game
   How the World is Assembled
   If You Get Stuck

   About Interactive Fiction
 > What to do with >
   Getting Started
   Rooms and Travel
   Objects
   Controlling the Game
   How the World is Assembled
   If You Get Stuck
   About Interactive Fiction
 > What to do with >
   Getting Started
   Rooms and Travel
   Objects
   Controlling the Game
   How the World is Assembled
   If You Get Stuck

 > About Interactive Fiction
   What to do with >
   Getting Started
   Rooms and Travel
   Objects
   Controlling the Game
   How the World is Assembled
   If You Get Stuck
 > About Interactive Fiction
   What to do with >
   Getting Started
   Rooms and Travel
   Objects
   Controlling the Game
   How the World is Assembled
   If You Get Stuck

The game you are playing is a work of Interactive Fiction.  In interactive fiction you play the main character of a story.  You type commands which determine the actions of the character and the flow of the plot.  Some IF games include graphics, but most do not: the imagery is provided courtesy of your imagination.  On the other hand, there's a wide range of action available: whereas in other games you may be restricted to shooting, movement, or searching items you can click on with a mouse, IF allows you a wide range of verbs.

Please press SPACE to continue.

 > About Interactive Fiction
   What to do with >
   Getting Started
   Rooms and Travel
   Objects
   Controlling the Game
   How the World is Assembled
   If You Get Stuck
 > About Interactive Fiction
   What to do with >
   Getting Started
   Rooms and Travel
   Objects
   Controlling the Game
   How the World is Assembled
   If You Get Stuck

   About Interactive Fiction
 > What to do with >
   Getting Started
   Rooms and Travel
   Objects
   Controlling the Game
   How the World is Assembled
   If You Get Stuck
   About Interactive Fiction
 > What to do with >
   Getting Started
   Rooms and Travel
   Objects
   Controlling the Game
   How the World is Assembled
   If You Get Stuck

* * *

   About Interactive Fiction
   What to do with >
 > Getting Started
   Rooms and Travel
   Objects
   Controlling the Game
   How the World is Assembled
   If You Get Stuck
   About Interactive Fiction
   What to do with >
 > Getting Started
   Rooms and Travel
   Objects
   Controlling the Game
   How the World is Assembled
   If You Get Stuck

The first thing you want to do when starting a game is acquaint yourself with your surroundings and get a sense of your goal. To this end, you should read the introductory text carefully. Sometimes it contains clues. You will also want to look at the room you are in. Notice where the exits from the room are, and what objects are described here. If any of these seem interesting, you may want to EXAMINE them. 

You might also want to examine yourself (EXAMINE ME) to see whether the author has left you any clues about your character. TAKE INVENTORY will tell you what you're carrying, as well.

Once you've gotten your bearings, you may want to explore. Move from room to room, and check out every location available.

Please press SPACE to continue.

* * *

   About Interactive Fiction
   What to do with >
 > Getting Started
   Rooms and Travel
   Objects
   Controlling the Game
   How the World is Assembled
   If You Get Stuck
   About Interactive Fiction
   What to do with >
 > Getting Started
   Rooms and Travel
   Objects
   Controlling the Game
   How the World is Assembled
   If You Get Stuck

   Introduction to Hyrule
 > Instructions for Play

Courtyard
The beautiful gardens you remember are gone. The calamity has tainted them. The only things that remain unaffected are three statues. Each statue seems to have a different personality to it. One looks powerful, the second looks courageous, and the third looks wise.

The Sanctum is to the north, through the Grand Entrance. The West Passage is to the west. The Library is to the east.

You can see a Powerful Statue, a Courageous statue, a Wise statue, and a sharp branch here.

* * *

   Introduction to Hyrule
   Instructions for Play
   Attacking
 > Placing
   Eating
   Introduction to Hyrule
   Instructions for Play
   Attacking
 > Placing
   Eating

   Introduction to Hyrule
   Instructions for Play
   Attacking
   Placing
 > Eating
   Introduction to Hyrule
   Instructions for Play
   Attacking
   Placing
 > Eating

 > Introduction to Hyrule
   Instructions for Play
 > Introduction to Hyrule
   Instructions for Play

* * *

   Introduction to Hyrule
   Instructions for Play
   Attacking
   Placing
 > Eating
   Introduction to Hyrule
   Instructions for Play
   Attacking
   Placing
 > Eating

   Introduction to Hyrule
   Instructions for Play
   Attacking
 > Placing
   Eating
   Introduction to Hyrule
   Instructions for Play
   Attacking
 > Placing
   Eating

   Introduction to Hyrule
   Instructions for Play
 > Attacking
   Placing
   Eating
   Introduction to Hyrule
   Instructions for Play
 > Attacking
   Placing
   Eating

   Introduction to Hyrule
 > Instructions for Play
   Attacking
   Placing
   Eating
   Introduction to Hyrule
 > Instructions for Play
   Attacking
   Placing
   Eating

* * *

   Introduction to Hyrule
   Instructions for Play
 > Attacking
   Placing
   Eating
   Introduction to Hyrule
   Instructions for Play
 > Attacking
   Placing
   Eating

In order to attack. use the command "stab {target} with {weapon}" if the weapon is a blade or "shoot {target} with {weapon} if it is ranged.

Please press SPACE to continue.

 > About Interactive Fiction
   What to do with >
   Getting Started
   Rooms and Travel
   Objects
   Controlling the Game
   How the World is Assembled
   If You Get Stuck
 > About Interactive Fiction
   What to do with >
   Getting Started
   Rooms and Travel
   Objects
   Controlling the Game
   How the World is Assembled
   If You Get Stuck

* * *

   About Interactive Fiction
 > What to do with >
   Getting Started
   Rooms and Travel
   Objects
   Controlling the Game
   How the World is Assembled
   If You Get Stuck
   About Interactive Fiction
 > What to do with >
   Getting Started
   Rooms and Travel
   Objects
   Controlling the Game
   How the World is Assembled
   If You Get Stuck

The > sign is where the game says, "Okay, what do you want to do now?"  You may respond by typing an instruction -- usually an imperative verb, possibly followed by prepositions and objects.  So, for instance, LOOK, LOOK AT FISH, TAKE FISH.

Please press SPACE to continue.

   About Interactive Fiction
 > What to do with >
   Getting Started
   Rooms and Travel
   Objects
   Controlling the Game
   How the World is Assembled
   If You Get Stuck
   About Interactive Fiction
 > What to do with >
   Getting Started
   Rooms and Travel
   Objects
   Controlling the Game
   How the World is Assembled
   If You Get Stuck

* * *

   About Interactive Fiction
   What to do with >
 > Getting Started
   Rooms and Travel
   Objects
   Controlling the Game
   How the World is Assembled
   If You Get Stuck
   About Interactive Fiction
   What to do with >
 > Getting Started
   Rooms and Travel
   Objects
   Controlling the Game
   How the World is Assembled
   If You Get Stuck

   About Interactive Fiction
   What to do with >
   Getting Started
 > Rooms and Travel
   Objects
   Controlling the Game
   How the World is Assembled
   If You Get Stuck
   About Interactive Fiction
   What to do with >
   Getting Started
 > Rooms and Travel
   Objects
   Controlling the Game
   How the World is Assembled
   If You Get Stuck

   About Interactive Fiction
   What to do with >
   Getting Started
   Rooms and Travel
 > Objects
   Controlling the Game
   How the World is Assembled
   If You Get Stuck
   About Interactive Fiction
   What to do with >
   Getting Started
   Rooms and Travel
 > Objects
   Controlling the Game
   How the World is Assembled
   If You Get Stuck

   About Interactive Fiction
   What to do with >
   Getting Started
   Rooms and Travel
   Objects
 > Controlling the Game
   How the World is Assembled
   If You Get Stuck
   About Interactive Fiction
   What to do with >
   Getting Started
   Rooms and Travel
   Objects
 > Controlling the Game
   How the World is Assembled
   If You Get Stuck

   About Interactive Fiction
   What to do with >
   Getting Started
   Rooms and Travel
   Objects
   Controlling the Game
 > How the World is Assembled
   If You Get Stuck
   About Interactive Fiction
   What to do with >
   Getting Started
   Rooms and Travel
   Objects
   Controlling the Game
 > How the World is Assembled
   If You Get Stuck

   About Interactive Fiction
   What to do with >
   Getting Started
   Rooms and Travel
   Objects
 > Controlling the Game
   How the World is Assembled
   If You Get Stuck
   About Interactive Fiction
   What to do with >
   Getting Started
   Rooms and Travel
   Objects
 > Controlling the Game
   How the World is Assembled
   If You Get Stuck

There are a few simple commands for controlling the game itself. These are: 

SAVE saves a snapshot of the game as it is now. 
RESTORE puts the game back to a previous saved state. You may keep as many saved games as you like. 
RESTART puts the game back to the way it was at the beginning. 
QUIT ends the game.

Please press SPACE to continue.

   About Interactive Fiction
   What to do with >
   Getting Started
   Rooms and Travel
   Objects
 > Controlling the Game
   How the World is Assembled
   If You Get Stuck
   About Interactive Fiction
   What to do with >
   Getting Started
   Rooms and Travel
   Objects
 > Controlling the Game
   How the World is Assembled
   If You Get Stuck

   About Interactive Fiction
   What to do with >
   Getting Started
   Rooms and Travel
   Objects
 > Controlling the Game
   How the World is Assembled
   If You Get Stuck

   About Interactive Fiction
   What to do with >
   Getting Started
   Rooms and Travel
   Objects
   Controlling the Game
 > How the World is Assembled
   If You Get Stuck
   About Interactive Fiction
   What to do with >
   Getting Started
   Rooms and Travel
   Objects
   Controlling the Game
 > How the World is Assembled
   If You Get Stuck

 > Space
   Containment
   Types of Action
   Other Characters

Most IF games are set in a world made up of rooms without internal division. Movement between rooms is possible; movement within a room does not always amount to anything. >WALK OVER TO THE DESK is rarely a useful sort of command. On the other hand, if something is described as being high or out of reach, it is sometimes relevant to stand on an object to increase your height. This kind of activity tends to be important only if prompted by the game text.

Please press SPACE to continue.

 > Space
   Containment
   Types of Action
   Other Characters
 > Space
   Containment
   Types of Action
   Other Characters

>p
 > Space
   Containment
   Types of Action
   Other Characters
 > Space
   Containment
   Types of Action
   Other Characters

   Space
 > Containment
   Types of Action
   Other Characters
   Space
 > Containment
   Types of Action
   Other Characters

   Space
   Containment
 > Types of Action
   Other Characters
   Space
   Containment
 > Types of Action
   Other Characters

   Space
   Containment
   Types of Action
 > Other Characters
   Space
   Containment
   Types of Action
 > Other Characters

   About Interactive Fiction
   What to do with >
   Getting Started
   Rooms and Travel
   Objects
   Controlling the Game
 > How the World is Assembled
   If You Get Stuck

   About Interactive Fiction
   What to do with >
   Getting Started
   Rooms and Travel
   Objects
   Controlling the Game
   How the World is Assembled
 > If You Get Stuck
   About Interactive Fiction
   What to do with >
   Getting Started
   Rooms and Travel
   Objects
   Controlling the Game
   How the World is Assembled
 > If You Get Stuck

 > Explore
   Read carefully
   Be creative
   Cooperate

   About Interactive Fiction
   What to do with >
   Getting Started
   Rooms and Travel
   Objects
   Controlling the Game
   How the World is Assembled
 > If You Get Stuck

 > Explore
   Read carefully
   Be creative
   Cooperate

 > Explore
   Read carefully
   Be creative
   Cooperate
 > Explore
   Read carefully
   Be creative
   Cooperate

Examine every object and look at everything in your inventory. Open all the doors you can find, and go through them. Look inside all closed containers. Make sure you've exhausted all the options in your environment. 

Try out all your senses. If the game mentions texture, odor, or sound, try touching, smelling, listening to, or tasting objects.

Be thorough. If you still can't figure out what to do, try opening windows, looking under beds, etc. Sometimes objects are well-hidden.

Please press SPACE to continue.

 > Explore
   Read carefully
   Be creative
   Cooperate
 > Explore
   Read carefully
   Be creative
   Cooperate

   Explore
 > Read carefully
   Be creative
   Cooperate
   Explore
 > Read carefully
   Be creative
   Cooperate

Reread. Look back at things you've already looked at. Sometimes this will trigger an idea you hadn't thought of. 

Take hints from the prose of the game. Things that are described in great detail are probably more important than things that are given one-liners. Play with those objects. If a machine is described as having component parts, look at the parts, and try manipulating them.  Likewise, notice the verbs that the game itself uses. Try using those yourself. Games often include special verbs -- the names of magic spells, or other special commands. There's no harm in attempting something if the game mentions it.

Check the whole screen. Are there extra windows besides the main window?  What's going on in those?  Check out the status bar, if there is one -- it may contain the name of the room you're in, your score, the time of day, your character's state of health, or some other important information.  If there's something up there, it's worth paying attention to that, too.  When and where does it change?  Why is it significant?  If the bar is describing your character's health, you can bet there is probably a point at which that will be important.

Please press SPACE to continue.

   Explore
 > Read carefully
   Be creative
   Cooperate
   Explore
 > Read carefully
   Be creative
   Cooperate

   About Interactive Fiction
   What to do with >
   Getting Started
   Rooms and Travel
   Objects
   Controlling the Game
   How the World is Assembled
 > If You Get Stuck

   About Interactive Fiction
   What to do with >
   Getting Started
   Rooms and Travel
   Objects
   Controlling the Game
 > How the World is Assembled
   If You Get Stuck
   About Interactive Fiction
   What to do with >
   Getting Started
   Rooms and Travel
   Objects
   Controlling the Game
 > How the World is Assembled
   If You Get Stuck

* * *

   About Interactive Fiction
   What to do with >
   Getting Started
   Rooms and Travel
   Objects
 > Controlling the Game
   How the World is Assembled
   If You Get Stuck
   About Interactive Fiction
   What to do with >
   Getting Started
   Rooms and Travel
   Objects
 > Controlling the Game
   How the World is Assembled
   If You Get Stuck

   Introduction to Hyrule
 > Instructions for Play
   Attacking
   Placing
   Eating

 > Introduction to Hyrule
   Instructions for Play
   Attacking
   Placing
   Eating
 > Introduction to Hyrule
   Instructions for Play
   Attacking
   Placing
   Eating

This is a simple demonstration Fiction game.

Please press SPACE to continue.

 > Introduction to Hyrule
   Instructions for Play
   Attacking
   Placing
   Eating
 > Introduction to Hyrule
   Instructions for Play
   Attacking
   Placing
   Eating

   Introduction to Hyrule
 > Instructions for Play
   Attacking
   Placing
   Eating
   Introduction to Hyrule
 > Instructions for Play
   Attacking
   Placing
   Eating

 > About Interactive Fiction
   What to do with >
   Getting Started
   Rooms and Travel
   Objects
   Controlling the Game
   How the World is Assembled
   If You Get Stuck

 > About Interactive Fiction
   What to do with >
   Getting Started
   Rooms and Travel
   Objects
   Controlling the Game
   How the World is Assembled
   If You Get Stuck

>p
 > About Interactive Fiction
   What to do with >
   Getting Started
   Rooms and Travel
   Objects
   Controlling the Game
   How the World is Assembled
   If You Get Stuck
 > About Interactive Fiction
   What to do with >
   Getting Started
   Rooms and Travel
   Objects
   Controlling the Game
   How the World is Assembled
   If You Get Stuck

>n
   About Interactive Fiction
 > What to do with >
   Getting Started
   Rooms and Travel
   Objects
   Controlling the Game
   How the World is Assembled
   If You Get Stuck
   About Interactive Fiction
 > What to do with >
   Getting Started
   Rooms and Travel
   Objects
   Controlling the Game
   How the World is Assembled
   If You Get Stuck

   About Interactive Fiction
   What to do with >
 > Getting Started
   Rooms and Travel
   Objects
   Controlling the Game
   How the World is Assembled
   If You Get Stuck
   About Interactive Fiction
   What to do with >
 > Getting Started
   Rooms and Travel
   Objects
   Controlling the Game
   How the World is Assembled
   If You Get Stuck

* * *

   About Interactive Fiction
   What to do with >
 > Getting Started
   Rooms and Travel
   Objects
   Controlling the Game
   How the World is Assembled
   If You Get Stuck
   About Interactive Fiction
   What to do with >
 > Getting Started
   Rooms and Travel
   Objects
   Controlling the Game
   How the World is Assembled
   If You Get Stuck

* * *

   About Interactive Fiction
   What to do with >
   Getting Started
 > Rooms and Travel
   Objects
   Controlling the Game
   How the World is Assembled
   If You Get Stuck
   About Interactive Fiction
   What to do with >
   Getting Started
 > Rooms and Travel
   Objects
   Controlling the Game
   How the World is Assembled
   If You Get Stuck

At any given time, you are in a specific location, or room. When you go into a room, the game will print a description of what you can see there. This description will contain two vital kinds of information: things in the room you can interact with or take, and a list of exits, or ways out. If you want to see the description again, you may just type LOOK. 

When you want to leave a location and go to another one, you may communicate this to the game using compass directions: eg, GO NORTH. For simplicity's sake, you are allowed to omit the word GO, and to abbreviate the compass directions. So you may use NORTH, SOUTH, EAST, WEST, NORTHEAST, SOUTHEAST, NORTHWEST, SOUTHWEST, UP, and DOWN, or in short form N, S, E, W, NE, SE, NW, SW, U, and D.

In some locations, IN and OUT will also be useful.

Please press SPACE to continue.

   About Interactive Fiction
   What to do with >
   Getting Started
 > Rooms and Travel
   Objects
   Controlling the Game
   How the World is Assembled
   If You Get Stuck
   About Interactive Fiction
   What to do with >
   Getting Started
 > Rooms and Travel
   Objects
   Controlling the Game
   How the World is Assembled
   If You Get Stuck

* * *

   About Interactive Fiction
   What to do with >
   Getting Started
   Rooms and Travel
 > Objects
   Controlling the Game
   How the World is Assembled
   If You Get Stuck
   About Interactive Fiction
   What to do with >
   Getting Started
   Rooms and Travel
 > Objects
   Controlling the Game
   How the World is Assembled
   If You Get Stuck

   Introduction to Hyrule
 > Instructions for Play
   Attacking
   Placing
   Eating

Courtyard
The beautiful gardens you remember are gone. The calamity has tainted them. The only things that remain unaffected are three statues. Each statue seems to have a different personality to it. One looks powerful, the second looks courageous, and the third looks wise.

The Sanctum is to the north, through the Grand Entrance. The West Passage is to the west. The Library is to the east.

You can see a Powerful Statue, a Courageous statue, a Wise statue, and a sharp branch here.

I beg your pardon?

* * *

In order to attack. use the command "stab {target} with {weapon}" if the weapon is a blade or "shoot {target} with {weapon} if it is ranged.

Please press SPACE to continue.

   Introduction to Hyrule
   Instructions for Play
 > Attacking
   Placing
   Eating
   Introduction to Hyrule
   Instructions for Play
 > Attacking
   Placing
   Eating

* * *

   Introduction to Hyrule
   Instructions for Play
   Attacking
 > Placing
   Eating
   Introduction to Hyrule
   Instructions for Play
   Attacking
 > Placing
   Eating

You can use the command "place {object} on {supporter}" to place an object in addition to the "put" action.

Please press SPACE to continue.

   Introduction to Hyrule
   Instructions for Play
   Attacking
 > Placing
   Eating
   Introduction to Hyrule
   Instructions for Play
   Attacking
 > Placing
   Eating

* * *

   Introduction to Hyrule
   Instructions for Play
   Attacking
   Placing
 > Eating
   Introduction to Hyrule
   Instructions for Play
   Attacking
   Placing
 > Eating

You will find food in some rooms. Eat it to restore health.

Please press SPACE to continue.

   Introduction to Hyrule
   Instructions for Play
   Attacking
   Placing
 > Eating
   Introduction to Hyrule
   Instructions for Play
   Attacking
   Placing
 > Eating

Courtyard
The beautiful gardens you remember are gone. The calamity has tainted them. The only things that remain unaffected are three statues. Each statue seems to have a different personality to it. One looks powerful, the second looks courageous, and the third looks wise.

The Sanctum is to the north, through the Grand Entrance. The West Passage is to the west. The Library is to the east.

You can see a Powerful Statue, a Courageous statue, a Wise statue, and a sharp branch here.

* * *

   Introduction to Hyrule
 > Instructions for Play
   Attacking
   Placing
   Eating
   Introduction to Hyrule
 > Instructions for Play
   Attacking
   Placing
   Eating

 > Introduction to Hyrule
   Instructions for Play
 > Introduction to Hyrule
   Instructions for Play

* * *

 > About Interactive Fiction
   What to do with >
   Getting Started
   Rooms and Travel
   Objects
   Controlling the Game
   How the World is Assembled
   If You Get Stuck

>help
 > Introduction to Hyrule
   Instructions for Play

>n
   Introduction to Hyrule
 > Instructions for Play
   Introduction to Hyrule
 > Instructions for Play

   Introduction to Hyrule
 > Instructions for Play
   Introduction to Hyrule
 > Instructions for Play

 > Introduction to Hyrule
   Instructions for Play
 > Introduction to Hyrule
   Instructions for Play

This is a simple demonstration Fiction game.

Please press SPACE to continue.

* * *

 > Introduction to Hyrule
   Instructions for Play
 > Introduction to Hyrule
   Instructions for Play

>n
   Introduction to Hyrule
 > Instructions for Play
   Introduction to Hyrule
 > Instructions for Play

   Introduction to Hyrule
 > Instructions for Play

 > Introduction to Hyrule
   Instructions for Play
 > Introduction to Hyrule
   Instructions for Play

* * *

This is a simple demonstration Fiction game.

Please press SPACE to continue.

 > Introduction to Hyrule
   Instructions for Play
 > Introduction to Hyrule
   Instructions for Play

* * *

 > About Interactive Fiction
   What to do with >
   Getting Started
   Rooms and Travel
   Objects
   Controlling the Game
   How the World is Assembled
   If You Get Stuck

   Introduction to Hyrule
 > Instructions for Play

 > About Interactive Fiction
   What to do with >
   Getting Started
   Rooms and Travel
   Objects
   Controlling the Game
   How the World is Assembled
   If You Get Stuck

* * *

 > Introduction to Hyrule
   Instructions for Play
 > Introduction to Hyrule
   Instructions for Play

 > Introduction to Hyrule
   Instructions for Play

This is a simple demonstration Fiction game.

Please press SPACE to continue.

* * *

>n
   Introduction to Hyrule
 > Instructions for Play
   Introduction to Hyrule
 > Instructions for Play

>n
   Introduction to Hyrule
 > Instructions for Play
   Introduction to Hyrule
 > Instructions for Play

>m
   Introduction to Hyrule
 > Instructions for Play

>p
 > Introduction to Hyrule
   Instructions for Play
 > Introduction to Hyrule
   Instructions for Play

This is a simple demonstration Fiction game.

Please press SPACE to continue.

* * *

 > Introduction to Hyrule
   Instructions for Play

   Introduction to Hyrule
 > Instructions for Play
   Introduction to Hyrule
 > Instructions for Play

* * *

   About Interactive Fiction
   What to do with >
   Getting Started
 > Rooms and Travel
   Objects
   Controlling the Game
   How the World is Assembled
   If You Get Stuck
   About Interactive Fiction
   What to do with >
   Getting Started
 > Rooms and Travel
   Objects
   Controlling the Game
   How the World is Assembled
   If You Get Stuck

   About Interactive Fiction
   What to do with >
 > Getting Started
   Rooms and Travel
   Objects
   Controlling the Game
   How the World is Assembled
   If You Get Stuck
   About Interactive Fiction
   What to do with >
 > Getting Started
   Rooms and Travel
   Objects
   Controlling the Game
   How the World is Assembled
   If You Get Stuck

* * *

   About Interactive Fiction
   What to do with >
   Getting Started
   Rooms and Travel
   Objects
   Controlling the Game
 > How the World is Assembled
   If You Get Stuck
   About Interactive Fiction
   What to do with >
   Getting Started
   Rooms and Travel
   Objects
   Controlling the Game
 > How the World is Assembled
   If You Get Stuck

   About Interactive Fiction
   What to do with >
   Getting Started
   Rooms and Travel
   Objects
   Controlling the Game
   How the World is Assembled
 > If You Get Stuck
   About Interactive Fiction
   What to do with >
   Getting Started
   Rooms and Travel
   Objects
   Controlling the Game
   How the World is Assembled
 > If You Get Stuck

* * *

 > Explore
   Read carefully
   Be creative
   Cooperate

Examine every object and look at everything in your inventory. Open all the doors you can find, and go through them. Look inside all closed containers. Make sure you've exhausted all the options in your environment. 

Try out all your senses. If the game mentions texture, odor, or sound, try touching, smelling, listening to, or tasting objects.

Be thorough. If you still can't figure out what to do, try opening windows, looking under beds, etc. Sometimes objects are well-hidden.

Please press SPACE to continue.

* * *

 > Explore
   Read carefully
   Be creative
   Cooperate
 > Explore
   Read carefully
   Be creative
   Cooperate

 > Explore
   Read carefully
   Be creative
   Cooperate
 > Explore
   Read carefully
   Be creative
   Cooperate

* * *

   Explore
 > Read carefully
   Be creative
   Cooperate
   Explore
 > Read carefully
   Be creative
   Cooperate

 > Explore
   Read carefully
   Be creative
   Cooperate
 > Explore
   Read carefully
   Be creative
   Cooperate

* * *

   Explore
 > Read carefully
   Be creative
   Cooperate
   Explore
 > Read carefully
   Be creative
   Cooperate

   Explore
   Read carefully
 > Be creative
   Cooperate
   Explore
   Read carefully
 > Be creative
   Cooperate

   About Interactive Fiction
   What to do with >
   Getting Started
   Rooms and Travel
   Objects
   Controlling the Game
   How the World is Assembled
 > If You Get Stuck

* * *

 > Space
   Containment
   Types of Action
   Other Characters

   About Interactive Fiction
   What to do with >
   Getting Started
   Rooms and Travel
   Objects
   Controlling the Game
 > How the World is Assembled
   If You Get Stuck

   About Interactive Fiction
   What to do with >
   Getting Started
   Rooms and Travel
   Objects
 > Controlling the Game
   How the World is Assembled
   If You Get Stuck
   About Interactive Fiction
   What to do with >
   Getting Started
   Rooms and Travel
   Objects
 > Controlling the Game
   How the World is Assembled
   If You Get Stuck

* * *

   About Interactive Fiction
   What to do with >
   Getting Started
   Rooms and Travel
   Objects
 > Controlling the Game
   How the World is Assembled
   If You Get Stuck
   About Interactive Fiction
   What to do with >
   Getting Started
   Rooms and Travel
   Objects
 > Controlling the Game
   How the World is Assembled
   If You Get Stuck

   About Interactive Fiction
   What to do with >
   Getting Started
   Rooms and Travel
 > Objects
   Controlling the Game
   How the World is Assembled
   If You Get Stuck
   About Interactive Fiction
   What to do with >
   Getting Started
   Rooms and Travel
 > Objects
   Controlling the Game
   How the World is Assembled
   If You Get Stuck

Throughout the game there will be assorted objects that you can do things with. Most importantly, you may TAKE or GET items, and (when you are tired of them) DROP them again. INVENTORY (abbreviated I) will list the items you are currently holding. 

There are usually assorted things you may do with these objects. OPEN, CLOSE, WEAR, EAT, LOCK, and UNLOCK are especially common.

Occasionally, you will find that the game does not recognize the name of an object even though it has been described as being in the room with you. If this is the case, the object is just there for scenery, and you may assume that you do not need to interact with it.

Please press SPACE to continue.

* * *

   About Interactive Fiction
   What to do with >
   Getting Started
   Rooms and Travel
 > Objects
   Controlling the Game
   How the World is Assembled
   If You Get Stuck
   About Interactive Fiction
   What to do with >
   Getting Started
   Rooms and Travel
 > Objects
   Controlling the Game
   How the World is Assembled
   If You Get Stuck

   About Interactive Fiction
   What to do with >
   Getting Started
 > Rooms and Travel
   Objects
   Controlling the Game
   How the World is Assembled
   If You Get Stuck
   About Interactive Fiction
   What to do with >
   Getting Started
 > Rooms and Travel
   Objects
   Controlling the Game
   How the World is Assembled
   If You Get Stuck

* * *

 > About Interactive Fiction
   What to do with >
   Getting Started
   Rooms and Travel
   Objects
   Controlling the Game
   How the World is Assembled
   If You Get Stuck
 > About Interactive Fiction
   What to do with >
   Getting Started
   Rooms and Travel
   Objects
   Controlling the Game
   How the World is Assembled
   If You Get Stuck

   Introduction to Hyrule
 > Instructions for Play

* * *

   About Interactive Fiction
   What to do with >
   Getting Started
   Rooms and Travel
   Objects
   Controlling the Game
   How the World is Assembled
 > If You Get Stuck
   About Interactive Fiction
   What to do with >
   Getting Started
   Rooms and Travel
   Objects
   Controlling the Game
   How the World is Assembled
 > If You Get Stuck

   About Interactive Fiction
   What to do with >
   Getting Started
   Rooms and Travel
   Objects
   Controlling the Game
 > How the World is Assembled
   If You Get Stuck
   About Interactive Fiction
   What to do with >
   Getting Started
   Rooms and Travel
   Objects
   Controlling the Game
 > How the World is Assembled
   If You Get Stuck

* * *

 > Explore
   Read carefully
   Be creative
   Cooperate

   Explore
 > Read carefully
   Be creative
   Cooperate
   Explore
 > Read carefully
   Be creative
   Cooperate

* * *

   Explore
   Read carefully
 > Be creative
   Cooperate
   Explore
   Read carefully
 > Be creative
   Cooperate

Rephrase. If there's something you want to do, but the game doesn't seem to understand you, try alternative wordings. 

Try variations. Sometimes an action doesn't work, but does produce some kind of unusual result. These are often indications that you're on the right track, even if you haven't figured out quite the right approach yet. Pressing the red button alone may only cause a grinding noise from inside the wall, so perhaps pressing the blue and then the red will open the secret door.

Consider the genre of the game. Mysteries, romances, and thrillers all have their own types of action and motivation. What are you trying to do, and how do conventional characters go about doing that? What's the right sort of behavior for a detective/romance heroine/spy?

Please press SPACE to continue.

   Explore
   Read carefully
 > Be creative
   Cooperate
   Explore
   Read carefully
 > Be creative
   Cooperate

* * *

   About Interactive Fiction
   What to do with >
   Getting Started
   Rooms and Travel
   Objects
   Controlling the Game
   How the World is Assembled
 > If You Get Stuck

   Introduction to Hyrule
 > Instructions for Play

* * *

>help
> Introduction to Hyrule Castle
   Instructions for Play
   Attacking
   Placing
   Eating

>[enter]
This is a simple demonstration Fiction game.

Please press SPACE to continue.

>[enter]
> Introduction to Hyrule Castle
   Instructions for Play
   Attacking
   Placing
   Eating

 > Introduction to Hyrule Castle
   Instructions for Play
   Attacking
   Placing
   Eating

>[down]
Introduction to Hyrule Castle
 > Instructions for Play
   Attacking
   Placing
   Eating

   Introduction to Hyrule Castle
 > Instructions for Play
   Attacking
   Placing
   Eating

>[down]
Introduction to Hyrule Castle
   Instructions for Play
 > Attacking
   Placing
   Eating

   Introduction to Hyrule Castle
   Instructions for Play
 > Attacking
   Placing
   Eating

>[enter]
In order to attack. use the command "stab {target} with {weapon}" if the weapon is a blade or "shoot {target} with {weapon} if it is ranged.

Please press SPACE to continue.

>[enter]
Introduction to Hyrule Castle
   Instructions for Play
 > Attacking
   Placing
   Eating

   Introduction to Hyrule Castle
   Instructions for Play
 > Attacking
   Placing
   Eating

>[down]
Introduction to Hyrule Castle
   Instructions for Play
   Attacking
 > Placing
   Eating

   Introduction to Hyrule Castle
   Instructions for Play
   Attacking
 > Placing
   Eating

>[enter]
You can use the command "place {object} on {supporter}" to place an object in addition to the "put" action.

Please press SPACE to continue.

>[enter]
Introduction to Hyrule Castle
   Instructions for Play
   Attacking
 > Placing
   Eating

   Introduction to Hyrule Castle
   Instructions for Play
   Attacking
 > Placing
   Eating

>[down]
Introduction to Hyrule Castle
   Instructions for Play
   Attacking
   Placing
 > Eating

   Introduction to Hyrule Castle
   Instructions for Play
   Attacking
   Placing
 > Eating

>[enter]
You will find food in some rooms. Eat it to restore health.

Please press SPACE to continue.

>[enter]
Introduction to Hyrule Castle
   Instructions for Play
   Attacking
   Placing
 > Eating

   Introduction to Hyrule Castle
   Instructions for Play
   Attacking
   Placing
 > Eating

>[up]
Introduction to Hyrule Castle
   Instructions for Play
   Attacking
 > Placing
   Eating

   Introduction to Hyrule Castle
   Instructions for Play
   Attacking
 > Placing
   Eating

>[up]
Introduction to Hyrule Castle
   Instructions for Play
 > Attacking
   Placing
   Eating

   Introduction to Hyrule Castle
   Instructions for Play
 > Attacking
   Placing
   Eating

>[up]
Introduction to Hyrule Castle
 > Instructions for Play
   Attacking
   Placing
   Eating

   Introduction to Hyrule Castle
 > Instructions for Play
   Attacking
   Placing
   Eating

>[up]
> Introduction to Hyrule Castle
   Instructions for Play
   Attacking
   Placing
   Eating

 > Introduction to Hyrule Castle
   Instructions for Play
   Attacking
   Placing
   Eating

>[enter]
This is a simple demonstration Fiction game.

Please press SPACE to continue.

* * *

>[down]
Introduction to Hyrule Castle
 > Instructions for Play
   Attacking
   Placing
   Eating

   Introduction to Hyrule Castle
 > Instructions for Play
   Attacking
   Placing
   Eating

>[enter]
> About Interactive Fiction
   What to do with >
   Getting Started
   Rooms and Travel
   Objects
   Controlling the Game
   How the World is Assembled
   If You Get Stuck

>[esc]
Introduction to Hyrule Castle
 > Instructions for Play
   Attacking
   Placing
   Eating

>[down]
Introduction to Hyrule Castle
   Instructions for Play
 > Attacking
   Placing
   Eating

   Introduction to Hyrule Castle
   Instructions for Play
 > Attacking
   Placing
   Eating

>[down]
Introduction to Hyrule Castle
   Instructions for Play
   Attacking
 > Placing
   Eating

   Introduction to Hyrule Castle
   Instructions for Play
   Attacking
 > Placing
   Eating

* * *

>[enter]
Introduction to Hyrule Castle
   Instructions for Play
   Attacking
 > Placing
   Eating

   Introduction to Hyrule Castle
   Instructions for Play
   Attacking
 > Placing
   Eating

* * *

>[enter]
Introduction to Hyrule Castle
   Instructions for Play
   Attacking
   Placing
 > Eating

   Introduction to Hyrule Castle
   Instructions for Play
   Attacking
   Placing
 > Eating

>[esc]
Courtyard
The beautiful gardens you remember are gone. The calamity has tainted them. The only things that remain unaffected are three statues. Each statue seems to have a different personality to it. One looks powerful, the second looks courageous, and the third looks wise.

The Sanctum is to the north, through the Grand Entrance. The West Passage is to the west. The Library is to the east.

You can see a Powerful Statue, a Courageous statue, a Wise statue, and a sharp branch here.

* * *

After a long and grueling battle against the calamity, you find yourself in the courtyard of Hyrule Castle. The calamity has corrupted this land and its influence can be battled with objects of great power. Find the pearls of the goddesses that have been scattered throughout Hyrule Castle and return them to the statues before your time runs out.

Hyrule Castle
An Interactive Fiction by Joe DeLuca
Release 1 / Serial number 190324 / Inform 7 build 6M62 (I6/v6.33 lib 6/12N) SD

North Side
You can see Gohma here.

>status
That's not a verb I recognise.

>look
Courtyard
You can see an Armory Door, a Sanctum Door, a statue of Din, a statue of Farore and a statue of Naryu here.

You took 3 damage from the calamity. Your current health is 97.

* * *

After a long and grueling battle against the calamity, you find yourself in the courtyard of Hyrule Castle. The calamity has corrupted this land and its influence can be battled with objects of great power. Find the pearls of the goddesses that have been scattered throughout Hyrule Castle and return them to the statues before your time runs out.

Hyrule Castle
An Interactive Fiction by Joe DeLuca
Release 1 / Serial number 190324 / Inform 7 build 6M62 (I6/v6.33 lib 6/12N) SD

North Side
You can see Gohma here.

>eat steak
(first taking the steak)
You took 3 damage from the calamity. Your current health is 107.

* * *

After a long and grueling battle against the calamity, you find yourself in the courtyard of Hyrule Castle. The calamity has corrupted this land and its influence can be battled with objects of great power. Find the pearls of the goddesses that have been scattered throughout Hyrule Castle and return them to the statues before your time runs out.

Hyrule Castle
An Interactive Fiction by Joe DeLuca
Release 1 / Serial number 190324 / Inform 7 build 6M62 (I6/v6.33 lib 6/12N) SD

North Side
You can see Gohma here.

>go west
West Passage
A passage on the west side of Hyrule Castle. There is not much here except for a window.

The Northwest Passage is to the northwest. The Guard Chamber is to the west. The Southwest Passage is to the southwest. The Courtyard is to the east.

>go east
Courtyard
The calamity stricken courtyard. 

You can see a Sanctum Door, a Powerful Statue, a Courageous statue, and a Wise statue here.

You took 3 damage from the calamity. Your current health is 97.

* * *

>go west
West Passage
A passage on the west side of Hyrule Castle. There is not much here except for a window.

The Northwest Passage is to the northwest. The Guard Chamber is to the west. The Southwest Passage is to the southwest. The Courtyard is to the east.

>look
West Passage

>examine window
You see nothing special about the forest window.

>go west
Guard Chamber
The chamber where the royal guards would spend their breaks.

The West Passage is to the east. The Northwest Passage is to the north. The Southwest Passage is to the south. 

You can see a metal chair, a metal table, and a key-hook (on which is a guard key) here.

>take key
Taken.

>go north
Northwest Passage
You can see The Lockup Door and a hebra window here.

>unlock door
(with the guard key)
You unlock The Lockup Door.

>go north
(first opening The Lockup Door)

Lockup
This is the room where prisoners were kept.

The The Lockup Door is to the south.

You can see four cells (closed and empty) and a big cell (closed) (in which is Green Pearl) here.

>unlock big cell
(with the guard key)
You unlock the big cell.

* * *

>go west
West Passage
A passage on the west side of Hyrule Castle. There is not much here except for a window.

The Northwest Passage is to the northwest. The Guard Chamber is to the west. The Southwest Passage is to the southwest. The Courtyard is to the east.

>examine window
You see nothing special about the forest window.

* * *

>take key
Taken.

>go north
Northwest Passage

>go north
Lockup
This is the room where prisoners were kept.

The Northwest Passage is to the south.

You can see four cells (closed and empty) and a big cell (closed) (in which is Green Pearl) here.

>unlock big cell
(with the guard key)
You unlock the big cell.

>take pearl
The big cell isn't open.

>open big cell
You open the big cell.

* * *

>go west
West Passage
A passage on the west side of Hyrule Castle. There is not much here except for a window.

The Northwest Passage is to the northwest. The Guard Chamber is to the west. The Southwest Passage is to the southwest. The Courtyard is to the east.

>go west
Guard Chamber
The chamber where the royal guards would spend their breaks.

The West Passage is to the east. The Northwest Passage is to the north. The Southwest Passage is to the south. 

You can see a metal chair, a metal table, and a key-hook (on which is a guard key) here.

* * *

>take key
Taken.

>go north
Northwest Passage
A fancy green rug.

>go north
Lockup
This is the room where prisoners were kept.

The Northwest Passage is to the south.

You can see four cells (closed and empty) and a big cell (closed) (in which is Green Pearl) here.

>unlock big cell
(with the guard key)
The guard key vanishes

>open big cell
You open the big cell.

* * *

>take pearl
Taken.

>go south
Northwest Passage

>examine placard
You see nothing special about the farore placard.

>i
You are carrying: 
Farore's Pearl
(Health: 100)

>go south
Guard Chamber
The chamber where the royal guards would spend their breaks.

The West Passage is to the east. The Northwest Passage is to the north. The Southwest Passage is to the south. 

You can see a metal chair, a metal table, and a key-hook here.

>go south
Southwest Passage

>examine placard
You can't see any such thing.

>go south
Dining Hall
The room where the royal family would host guests for meals.

The Southwest Passage is to the north. The South passage is to the east.

You can see a Korok Door, a dining table (on which are a fruit bowl (in which are an apple, an orange, and a banana) and a knife), and eight chairs here.

You took 1 damage from the calamity. Your current health is 99.

>go west
(first opening the Korok Door)
It seems to be locked.

You took 1 damage from the calamity. Your current health is 98.

>go east
South passage
You can see The Armory Door and a rug here.

>examine placard
You see nothing special about the din placard.

>take rug
You notice a was hidden underneath the rug. That does not seem very secure.

>take key
Taken.

>drop rug
Dropped.

>unlock armory door
What do you want to unlock The Armory Door with?

>armory key
The armory key vanishes

>go north
(first opening The Armory Door)

Armory
You can see The Armory Door, a weapon rack (on which are five swords and two bows), and a chest (closed) here.

>open chest
You open the chest, revealing Din's Pearl.

>take key
You can't see any such thing.

>take pearl
(Din's Pearl)
Taken.

>go south
South passage
You can see The Armory Door and a rug here.

>go northeast
East passage

>examine placard
You see nothing special about the nayru placard.

>go north
Library
The walls a are lined with books. It seems like it would have been a nice place to relax.

The King's Door is to the north. The Courtyard is to the west. The East passage is to the south.

You can see a large bookshelf (on which is a blue book (closed)), a plush chair, and a fireplace here.

>open book
You open the blue book, revealing a royal key.

>take key
Taken.

>unlock king door with king key
You can't see any such thing.

>unlock king door with king's key
You can't see any such thing.

>go north
(first opening the King's Door)
It seems to be locked.

>take pearl
Which do you mean, Din's Pearl or Farore's Pearl?

>go south
East passage

>go west
You can't go that way.

>put red pearl on powerful statue
You can't see any such thing.

>put Din's Pearl on Din's Statue
I only understood you as far as wanting to put Din's Pearl on Din's Pearl.

>put Farore's Pearl on Farore's Statue
I only understood you as far as wanting to put Farore's Pearl on Farore's Pearl.

>put Nayru's Pearl on Nayru's statue
You can't see any such thing.

>look
East passage

>take sword
You can't see any such thing.

>i
You are carrying: 
a royal key
Din's Pearl
Farore's Pearl
(Health: 98)

>unlock grand entrance
You can't see any such thing.

>master sword
That's not a verb I recognise.

* * *

>go north
Northwest Passage
A fancy green rug.

>examine placard
You see nothing special about the farore placard.

>go north
Lockup
This is the room where prisoners were kept.

The Northwest Passage is to the south.

You can see four cells (closed and empty) and a big cell (closed) (in which is Farore's Pearl) here.

>unlock big cell
(with the guard key)
As you unlock the big cell, the guard key vanishes

>open big cell
You open the big cell.

* * *

>take pearl
Taken.

>go south
Northwest Passage
A fancy green rug.

>go south
Guard Chamber
The chamber where the royal guards would spend their breaks.

The West Passage is to the east. The Northwest Passage is to the north. The Southwest Passage is to the south. 

You can see a metal chair, a metal table, and a key-hook here.

* * *

>go south
Southwest Passage

>go south
Dining Hall
The room where the royal family would host guests for meals.

The Southwest Passage is to the north. The South passage is to the east.

You can see a Korok Door, a dining table (on which are a fruit bowl (in which are an apple, an orange, and a banana) and a knife), and eight chairs here.

You took 1 damage from the calamity. Your current health is 99.

>go east
South passage
A fancy red rug.

You can also see The Armory Door here.

>examine placard
You see nothing special about the din placard.

>examine rug
You see nothing special about the red rug.

Wait... there is something under this rug!

>move rug west
The red rug cannot be pushed from place to place.

>take rug
You notice a was hidden underneath the rug. That does not seem very secure.

* * *

>unlock armory door
What do you want to unlock The Armory Door with?

>armory key
As you unlock the Armory Door, the armory key vanishes

>i
You are carrying: 
Farore's Pearl
(Health: 99)

>go north
(first opening The Armory Door)

Armory
You can see The Armory Door, a weapon rack (on which are five swords and two bows), and a chest (closed) here.

* * *

>take pearl
(Din's Pearl)
Taken.

>go south
South passage
You can see The Armory Door and a red rug here.

>go east
Study
The room the royal family used when working. 

The Southwest Passage is to the west. The East passage is to the north

You can see a wooden desk (on which are a note and a pen) and a wooden chair here.

>go east
You can't go that way.

>go north
East passage
A fancy blue rug.

>examine placard
You see nothing special about the nayru placard.

* * *

>take key
Taken.

>unlock King's Door
What do you want to unlock the King's Door with?

>key
As you unlock the King's Door, the  royal key vanishes

>go north
(first opening the King's Door)

King's Chamber
You can see a King's Door, a king's bed, and an extravagent desk (on which is Nayru's Pearl) here.

>take pearl
(Nayru's Pearl)
Taken.

>go south
Library
The walls a are lined with books. It seems like it would have been a nice place to relax.

The King's Door is to the north. The Courtyard is to the west. The East passage is to the south.

You can see a large bookshelf (on which is a blue book (empty)), a plush chair, and a fireplace here.

>go east
You can't go that way.

>go west
Courtyard
The calamity stricken courtyard. 

The Grand Entrance is to the north. The West Passage is to the west. The Library is to the east.

You can see a Statue of Din, a Statue of Farore, and a Statue of Nayru here.

You took 3 damage from the calamity. Your current health is 96.

>place red pearl on powerful statue
Red energy emits from Din's Pearl. Some of the calamity disappeared!
Din's Pearl has been placed. You have placed 1 pearls.

You took 2 damage from the calamity. Your current health is 94.

>put blue pearl on wise statue
Blue energy emits from nayru's Pearl. Some of the calamity disappeared!
Nayru's Pearl has been placed. You have placed 2 pearls.

You took 1 damage from the calamity. Your current health is 93.

>put green pearl on courageous statue
Green energy emits from Farore's Pearl. Some of the calamity disappeared!
Farore's Pearl has been placed. You have placed 3 pearls.

A Blue sword with a winged hilt emerges from the center of the courtyard. You recognize this weapon. The Sword that Seals Darkness.... The Master Sword.

>take sword
Taken.

>stab myself with the master swor
I only understood you as far as wanting to stab yourself with the Master Sword.

>stab myself with the master sword
    *** You have committed suicide! ***

Would you like to RESTART, RESTORE a saved game, QUIT, or UNDO the last command?

>go west
Please give one of the answers above.

Would you like to RESTART, RESTORE a saved game, QUIT, or UNDO the last command?

>go west
Please give one of the answers above.

Would you like to RESTART, RESTORE a saved game, QUIT, or UNDO the last command?

>go south
Please give one of the answers above.

Would you like to RESTART, RESTORE a saved game, QUIT, or UNDO the last command?

>go south
Please give one of the answers above.

Would you like to RESTART, RESTORE a saved game, QUIT, or UNDO the last command?

>go east
Please give one of the answers above.

Would you like to RESTART, RESTORE a saved game, QUIT, or UNDO the last command?

>examine red rug
Please give one of the answers above.

Would you like to RESTART, RESTORE a saved game, QUIT, or UNDO the last command?

>g
Please give one of the answers above.

Would you like to RESTART, RESTORE a saved game, QUIT, or UNDO the last command?

>take red rug
Please give one of the answers above.

Would you like to RESTART, RESTORE a saved game, QUIT, or UNDO the last command?

>take key
Please give one of the answers above.

Would you like to RESTART, RESTORE a saved game, QUIT, or UNDO the last command?

* * *

>go west
West Passage
A passage on the west side of Hyrule Castle. There is not much here except for a window.

The Northwest Passage is to the northwest. The Guard Chamber is to the west. The Southwest Passage is to the southwest. The Courtyard is to the east.

>go northwest
Northwest Passage
A passage on the northwestern side of Hyrule Castle. A large green rug spans this passage. There is a window on the left side, and a painting on the right.

The Lockup is to the north. The Guard Chamber is to the south. The West Passage is to the southeast.

A fancy green rug.

>examine painting
A painting depicting a green goddess creating beings to inhabit the world and breathing life into them. At the top of the painting there is a golden triangle adorned with the green symbol of  Courage. 

There is a placard at the bottom.

>read placard
The placard reads: "A depiction of the goddess Farore creating the life of this realm. She is known for her liveliness and embodiment of Courage."

* * *

After a long and grueling battle against the calamity, you find yourself in the courtyard of Hyrule Castle. The calamity has corrupted this land and its influence can be battled with objects of great power. Find the pearls of the goddesses that have been scattered throughout Hyrule Castle and return them to the statues before your time runs out.

Hyrule Castle
An Interactive Fiction by Joe DeLuca
Release 1 / Serial number 190324 / Inform 7 build 6M62 (I6/v6.33 lib 6/12N) SD

North Side
You can see Gohma here.

>w
West Side

>se
You can't go that way.

>sw
Southwest Passage
A passage on the southwestern side of Hyrule Castle. There is a window on the left side. 

The Guard Chamber is to the north. The Dining Hall is to the south. The South passage is to the southwest. The Kitchen is to the west. The West Passage is to the northeast.

>s
Dining Hall
The room where the royal family would host guests for meals.

The Southwest Passage is to the north. The South passage is to the east.

You can see a Spring Door, a dining table (on which are a fruit bowl (in which are five Apples, five oranges, and five bananas) and a knife), eight chairs, and a sad korok here.

You took 1 damage from the calamity. Your current health is 99.

The korok is holding a strange key.

>talk to korok
That's not a verb I recognise.

>talk
That's not a verb I recognise.

>listen to korok
You hear nothing unexpected.

You took 1 damage from the calamity. Your current health is 98.

The korok is staring at the fruit bowl.

>ask korok
What do you want to ask the sad korok for?

>food
You can't see any such thing.

>take key from korok
That seems to belong to the sad korok.

You took 1 damage from the calamity. Your current health is 97.

The korok is moping in the corner.

>eat apple
(first taking the Apple)
You took 1 damage from the calamity. Your current health is 99.

The korok is holding a strange key.

>take apple
Taken.

You took 1 damage from the calamity. Your current health is 98.

The korok is holding a strange key.

>give apple to sad korok
WOW! Thank you! *chewing noises*
You took 1 damage from the calamity. Your current health is 97.

The korok gives you a grateful look.

>korok, give me the spring key
The sad korok gives the spring key to you.

You took 1 damage from the calamity. Your current health is 96.

The korok  is happily eating the food.

>unlock spring door
(with the spring key)
You unlock the Spring Door.

You took 1 damage from the calamity. Your current health is 95.

The korok  is happily eating the food.

>go west
(first opening the Spring Door)

Healing Spring
The waters in this pool shimmer with gold.

The Spring Door is to the east.

>enter pool
The waters of this pool have increased your vitality. Your maximum health is now 150.
Your health has been restored.

>go e
You would have to get out of the pool first.

>exit pool
I only understood you as far as wanting to exit.

>exit pool
I only understood you as far as wanting to exit.

>leave pool
I only understood you as far as wanting to leave.

>go east
You would have to get out of the pool first.

>get out of pool
I only understood you as far as wanting to get outside.

>get out
You get out of the pool.

Healing Spring
The waters in this pool shimmer with gold.

The Spring Door is to the east.

>go e
Dining Hall
The room where the royal family would host guests for meals.

The Southwest Passage is to the north. The South passage is to the east.

You can see a Spring Door, a dining table (on which are a fruit bowl (in which are three Apples, five oranges, and five bananas) and a knife), eight chairs, and a sad korok here.

You took 1 damage from the calamity. Your current health is 149.

The korok gives you a grateful look.

>sit on chair
You get onto the chair.

You took 1 damage from the calamity. Your current health is 148.

The korok gives you a grateful look.

>stand up
You get off the chair.

Dining Hall
The room where the royal family would host guests for meals.

The Southwest Passage is to the north. The South passage is to the east.

You can see a Spring Door, a dining table (on which are a fruit bowl (in which are three Apples, five oranges, and five bananas) and a knife), eight chairs, and a sad korok here.

You took 1 damage from the calamity. Your current health is 147.

The korok chews delightedly.

>ls
That's not a verb I recognise.

>i
You are carrying: 
a spring key
(Health: 147)

You took 1 damage from the calamity. Your current health is 146.

The korok  is happily eating the food.

>take knife
Taken.

You took 1 damage from the calamity. Your current health is 145.

The korok  is happily eating the food.

>attack korok with knife
I only understood you as far as wanting to attack the sad korok.

>attack sad korok with knife
I only understood you as far as wanting to attack the sad korok.

>stab sad korok with knife
With one final thrust of your knife, the sad korok's dead body drops to the ground, dead.

You took 1 damage from the calamity. Your current health is 144.

>ls
That's not a verb I recognise.

>look
Dining Hall
The room where the royal family would host guests for meals.

The Southwest Passage is to the north. The South passage is to the east.

You can see a Spring Door, a dining table (on which is a fruit bowl (in which are three Apples, five oranges, and five bananas)), eight chairs, and a sad korok's dead body here.

You took 1 damage from the calamity. Your current health is 143.

>give sad korok the knife
You give the knife to the sad korok's dead body.

You took 1 damage from the calamity. Your current health is 142.

* * *

>w
West Side

>n
North Side

>s
Temple of Time

>s
South Side

>e
East Side

>e
You can't go that way.

>n
North Side

>w
West Side

>e
Temple of Time

* * *

After a long and grueling battle against the calamity, you find yourself in the courtyard of Hyrule Castle. The calamity has corrupted this land and its influence can be battled with objects of great power. Find the pearls of the goddesses that have been scattered throughout Hyrule Castle and return them to the statues before your time runs out.

Hyrule Castle
An Interactive Fiction by Joe DeLuca
Release 1 / Serial number 190324 / Inform 7 build 6M62 (I6/v6.33 lib 6/12N) SD

North Side
You can see Gohma here.

>go w
West Passage
A passage on the west side of Hyrule Castle. There is not much here except for a window.

The Northwest Passage is to the northwest. The Guard Chamber is to the west. The Southwest Passage is to the southwest. The Courtyard is to the east.

You can see a Darknut here.

The Darknut stabs you! (Health: 84)

>sw
Southwest Passage
A passage on the southwestern side of Hyrule Castle. There is a window on the left side. 

The Guard Chamber is to the north. The Dining Hall is to the south. The South passage is to the southwest. The Kitchen is to the west. The West Passage is to the northeast.

>s
Dining Hall
The room where the royal family would host guests for meals.

The Southwest Passage is to the north. The South passage is to the east.

You can see a Spring Door, a dining table (on which are a fruit bowl (in which are five Apples, five oranges, and five bananas) and a knife), eight chairs, and a sad korok here.

You took 1 damage from the calamity. Your current health is 66.

The korok is holding a strange key.

>take knife
Taken.

You took 1 damage from the calamity. Your current health is 65.

The korok is staring at the fruit bowl.

>stab korok with knife
With one final thrust of your knife, the sad korok's dead body drops to the ground, dead.

You took 1 damage from the calamity. Your current health is 64.

>take spring key
Taken.

You took 1 damage from the calamity. Your current health is 63.

>n
Southwest Passage
A passage on the southwestern side of Hyrule Castle. There is a window on the left side. 

The Guard Chamber is to the north. The Dining Hall is to the south. The South passage is to the southwest. The Kitchen is to the west. The West Passage is to the northeast.

>n
Guard Chamber
The chamber where the royal guards would spend their breaks.

The West Passage is to the east. The Northwest Passage is to the north. The Southwest Passage is to the south. 

You can see a metal chair, a metal table, and a key-hook (on which is a guard key) here.

You took 2 damage from the calamity. Your current health is 61.

>take key
(the guard key)
Taken.

You took 2 damage from the calamity. Your current health is 59.

>n
Northwest Passage
A passage on the northwestern side of Hyrule Castle. A large green rug spans this passage. There is a window on the left side, and a painting on the right.

The Lockup is to the north. The Guard Chamber is to the south. The West Passage is to the southeast.

A fancy green rug.

>examine painting
A painting depicting a green goddess creating beings to inhabit the world and breathing life into them. At the top of the painting there is a golden triangle adorned with the green symbol of  Courage. 

There is a placard at the bottom.

* * *

>read placard
The placard reads: "A depiction of the goddess Farore creating the life of this realm. She is known for her liveliness and embodiment of Courage."

>n
Lockup
This is the room where prisoners were kept.

The Northwest Passage is to the south.

You can see four cells (closed and empty), a big cell (closed) (in which is Farore's Pearl), and a Moblin here.

The Moblin stabs you! (Health: 27)

>stab moblin
What do you want to stab the Moblin with?

>stab moblin with knife
(the Moblin with the knife)
You stab the Moblin with your the knife. The Moblin yells out in pain.  (The Moblin's health: 38)

The Moblin stabs you! (Health: 1)

>stab moblin with knife
(the Moblin with the knife)
You stab the Moblin with your the knife. The Moblin yells out in pain.  (The Moblin's health: 17)

The Moblin stabs you with the moblin spear, and you drop to the ground, dead.

    *** You have died. ***

Would you like to RESTART, RESTORE a saved game, QUIT, or UNDO the last command?

>stab moblin with knife
Please give one of the answers above.

Would you like to RESTART, RESTORE a saved game, QUIT, or UNDO the last command?

* * *

After a long and grueling battle against the calamity, you find yourself in the courtyard of Hyrule Castle. The calamity has corrupted this land and its influence can be battled with objects of great power. Find the pearls of the goddesses that have been scattered throughout Hyrule Castle and return them to the statues before your time runs out.

Hyrule Castle
An Interactive Fiction by Joe DeLuca
Release 1 / Serial number 190324 / Inform 7 build 6M62 (I6/v6.33 lib 6/12N) SD

North Side
You can see Gohma here.

>take branch
Taken.

You took 3 damage from the calamity. Your current health is 97.

>look
Courtyard
The beautiful gardens you remember are gone. The calamity has tainted them. The only things that remain unaffected are three statues. Each statue seems to have a different personality to it. One looks powerful, the second looks courageous, and the third looks wise.

The Sanctum is to the north, through the Grand Entrance. The West Passage is to the west. The Library is to the east.

You can see a Powerful Statue, a Courageous statue, and a Wise statue here.

You took 3 damage from the calamity. Your current health is 97.

* * *

>take branch
Taken.

You took 3 damage from the calamity. Your current health is 97.

>w
West Passage
A passage on the west side of Hyrule Castle. There is not much here except for a window.

The Northwest Passage is to the northwest. The Guard Chamber is to the west. The Southwest Passage is to the southwest. The Courtyard is to the east.

You can see a Darknut here.

The Darknut stabs you! (Health: 67)

>attack darknut
Violence isn't the answer to this one.

The Darknut stabs you! (Health: 58)

>attack darknut
Violence isn't the answer to this one.

The Darknut stabs you! (Health: 58)

>undo
West Passage
[Previous turn undone.]

>undo
West Passage
[Previous turn undone.]

>stab darknut with branch
You stab the Darknut with your the sharp branch. The Darknut yells out in pain.  (The Darknut's health: 20)

The Darknut stabs you! (Health: 64)

>stab darknut with branch
You stab the Darknut with your the sharp branch. The Darknut yells out in pain.  (The Darknut's health: 8)

The Darknut stabs you! (Health: 47)

>stab darknut with branch
With one final thrust of your sharp branch, the Darknut's dead body drops to the ground, dead.

>take sword
You can't see any such thing.

>look
West Passage
A passage on the west side of Hyrule Castle. There is not much here except for a window.

The Northwest Passage is to the northwest. The Guard Chamber is to the west. The Southwest Passage is to the southwest. The Courtyard is to the east.

You can see a Darknut's dead body here.

>take body
You can't see any such thing.

>w
Guard Chamber
The chamber where the royal guards would spend their breaks.

The West Passage is to the east. The Northwest Passage is to the north. The Southwest Passage is to the south. 

You can see a metal chair, a metal table, and a key-hook (on which is a guard key) here.

You took 2 damage from the calamity. Your current health is 45.

>take key
Taken.

You took 2 damage from the calamity. Your current health is 43.

>s
Southwest Passage
A passage on the southwestern side of Hyrule Castle. There is a window on the left side. 

The Guard Chamber is to the north. The Dining Hall is to the south. The South passage is to the southwest. The Kitchen is to the west. The West Passage is to the northeast.

>s
Dining Hall
The room where the royal family would host guests for meals.

The Southwest Passage is to the north. The South passage is to the east.

You can see a Spring Door, a dining table (on which are a fruit bowl (in which are five Apples, five oranges, and five bananas) and a knife), eight chairs, and a sad korok here.

You took 1 damage from the calamity. Your current health is 42.

The korok is holding a strange key.

>stab korok
What do you want to stab the sad korok with?

>sword
You can't see any such thing.

>take key
(the spring key)
That seems to belong to the sad korok.

You took 1 damage from the calamity. Your current health is 41.

The korok is moping in the corner.

>unlock spring door
What do you want to unlock the Spring Door with?

>spring key
(first taking the spring key)
That seems to belong to the sad korok.

You took 1 damage from the calamity. Your current health is 40.

The korok is staring at the fruit bowl.

>e
South passage
A passage on the southern side of Hyrule Castle. There is a window and a painting along the south wall. 

The Armory is to the north, through the The Armory Door. The Southwest Passage is to the northwest. The Dining Hall is to the west. The Study is to the east. The East passage is to the northeast.

A fancy red rug.

>w
Dining Hall
The room where the royal family would host guests for meals.

The Southwest Passage is to the north. The South passage is to the east.

You can see a Spring Door, a dining table (on which are a fruit bowl (in which are five Apples, five oranges, and five bananas) and a knife), eight chairs, and a sad korok here.

You took 1 damage from the calamity. Your current health is 39.

The korok is moping in the corner.

>w
(first opening the Spring Door)
It seems to be locked.

You took 1 damage from the calamity. Your current health is 38.

The korok whimpering.

>enter pool
You can't see any such thing.

>e
South passage
A passage on the southern side of Hyrule Castle. There is a window and a painting along the south wall. 

The Armory is to the north, through the The Armory Door. The Southwest Passage is to the northwest. The Dining Hall is to the west. The Study is to the east. The East passage is to the northeast.

A fancy red rug.

>get out
But you aren't in anything at the moment.

>e
Study
The room the royal family used when working. 

The Southwest Passage is to the west. The East passage is to the north

You can see a wooden desk (on which are a note and a pen) and a wooden chair here.

You took 1 damage from the calamity. Your current health is 37.

>take all fruit
You can't see any such thing.

I beg your pardon?

>i
You are carrying: 
a guard key
a sharp branch
(Health: 37)

You took 1 damage from the calamity. Your current health is 36.

>e
You can't go that way.

You took 1 damage from the calamity. Your current health is 35.

>take fancy rug
You can't see any such thing.

>take rug
You can't see any such thing.

>take key
You already have that.

You took 1 damage from the calamity. Your current health is 34.

>unlock armory door
You can't see any such thing.

>armory key
That's not a verb I recognise.

>n
East passage
A passage on the eastern side of Hyrule Castle. There is a window on the right, and a painting to the left.

The Library is to the north. The South passage is to the southwest. The Study is to the south.

A fancy blue rug.

>attack darknut with sword
You can't see any such thing.

>stab darknut with sword
You can't see any such thing.

>stab darknut with darknut sword
You can't see any such thing.

>stab darknut with broadsword
You can't see any such thing.

* * *

>attack darknut
Violence isn't the answer to this one.

The Darknut stabs you! (Health: 58)

>stab darknut with branch
You stab the Darknut with your the sharp branch. The Darknut yells out in pain.  (The Darknut's health: 16)

The Darknut stabs you! (Health: 39)

>g
You stab the Darknut with your the sharp branch. The Darknut yells out in pain.  (The Darknut's health: 4)

The Darknut stabs you! (Health: 12)

>g
With one final thrust of your sharp branch, the Darknut's dead body drops to the ground, dead.

>take sword
You can't see any such thing.

>take broadsword
Taken.

* * *

>w
West Passage
A passage on the west side of Hyrule Castle. There is not much here except for a window.

The Northwest Passage is to the northwest. The Guard Chamber is to the west. The Southwest Passage is to the southwest. The Courtyard is to the east.

You can see a Darknut here.

The Darknut stabs you! (Health: 67)

>stab darknut with branch
You stab the Darknut with your the sharp branch. The Darknut yells out in pain.  (The Darknut's health: 18)

The Darknut stabs you! (Health: 69)

>stab darknut with branch
You stab the Darknut with your the sharp branch. The Darknut yells out in pain.  (The Darknut's health: 3)

The Darknut stabs you! (Health: 34)

>stab darknut with branch
With one final thrust of your sharp branch, the Darknut's dead body drops to the ground, dead.

>look
West Passage
A passage on the west side of Hyrule Castle. There is not much here except for a window.

The Northwest Passage is to the northwest. The Guard Chamber is to the west. The Southwest Passage is to the southwest. The Courtyard is to the east.

You can see a Darknut's dead body here.

>take sword
Taken.

>give sword to darknut
You give the broad sword to the Darknut's dead body.

>examine body
You can't see any such thing.

>examine darknut
Darknut's dead body is a gruesome sight.

* * *

>stab darknut with branch
You stab the Darknut with your the sharp branch. The Darknut yells out in pain.  (The Darknut's health: 18)

The Darknut stabs you! (Health: 69)

>g
You stab the Darknut with your the sharp branch. The Darknut yells out in pain.  (The Darknut's health: 3)

The Darknut stabs you! (Health: 51)

>g
With one final thrust of your sharp branch, the Darknut's dead body drops to the ground, dead.

>examine darknut
Darknut's dead body is a gruesome sight.

>look
West Passage
A passage on the west side of Hyrule Castle. There is not much here except for a window.

The Northwest Passage is to the northwest. The Guard Chamber is to the west. The Southwest Passage is to the southwest. The Courtyard is to the east.

You can see a Darknut's dead body here.

* * *

>take sword
Taken.

>go w
Guard Chamber
The chamber where the royal guards would spend their breaks.

The West Passage is to the east. The Northwest Passage is to the north. The Southwest Passage is to the south. 

You can see a metal chair, a metal table, and a key-hook (on which is a guard key) here.

You took 2 damage from the calamity. Your current health is 49.

>take key
Taken.

You took 2 damage from the calamity. Your current health is 47.

>s
Southwest Passage
A passage on the southwestern side of Hyrule Castle. There is a window on the left side. 

The Guard Chamber is to the north. The Dining Hall is to the south. The South passage is to the southwest. The Kitchen is to the west. The West Passage is to the northeast.

>s
Dining Hall
The room where the royal family would host guests for meals.

The Southwest Passage is to the north. The South passage is to the east.

You can see a Spring Door, a dining table (on which are a fruit bowl (in which are five Apples, five oranges, and five bananas) and a knife), eight chairs, and a sad korok here.

You took 1 damage from the calamity. Your current health is 46.

The korok is moping in the corner.

>take apple
Taken.

You took 1 damage from the calamity. Your current health is 45.

The korok is holding a strange key.

>take fruit bowl
Taken.

You took 1 damage from the calamity. Your current health is 44.

The korok is moping in the corner.

>give apple to korok
WOW! Thank you! *chewing noises*
You took 1 damage from the calamity. Your current health is 43.

The korok chews delightedly.

>korok, give me spring key
The sad korok gives the spring key to you.

You took 1 damage from the calamity. Your current health is 42.

The korok  is happily eating the food.

>unlock spring door
What do you want to unlock the Spring Door with?

>spring key
You unlock the Spring Door.

You took 1 damage from the calamity. Your current health is 41.

The korok  is happily eating the food.

>w
(first opening the Spring Door)

Healing Spring
The waters in this pool shimmer with gold.

The Spring Door is to the east.

>enter pool
The waters of this pool have increased your vitality. Your maximum health is now 150.
Your health has been restored.

>get out
You get out of the pool.

Healing Spring
The waters in this pool shimmer with gold.

The Spring Door is to the east.

>e
Dining Hall
The room where the royal family would host guests for meals.

The Southwest Passage is to the north. The South passage is to the east.

You can see a Spring Door, a dining table (on which is a knife), eight chairs, and a sad korok here.

You took 1 damage from the calamity. Your current health is 149.

The korok chews delightedly.

>e
South passage
A passage on the southern side of Hyrule Castle. There is a window and a painting along the south wall. 

The Armory is to the north, through the The Armory Door. The Southwest Passage is to the northwest. The Dining Hall is to the west. The Study is to the east. The East passage is to the northeast.

A fancy red rug.

>take rug
You notice a key was hidden underneath the rug. That does not seem very secure.

>take key
(the armory key)
Taken.

>drop rug
Dropped.

>unlock armory key
What do you want to unlock the armory key with?

>armory key
That doesn't seem to be something you can unlock.

>unlock armory door with armory key
As you unlock the Armory Door, the armory key vanishes

>n
(first opening The Armory Door)

Armory
This room holds the weapons and armor of the Royal Guard. Well, at least it used to...

The South passage is to the south, through the The Armory Door.

You can see a weapon rack (on which are five swords and two bows), a chest (closed), and a Darknut here.

You took 2 damage from the calamity. Your current health is 147.

The Darknut stabs you! (Health: 124)

>stab darknut with sword
(the broad sword)
With one final thrust of your broad sword, the Darknut's dead body drops to the ground, dead.

You took 2 damage from the calamity. Your current health is 122.

>open chest
You open the chest, revealing Red Pearl.

You took 2 damage from the calamity. Your current health is 120.

>take pearl
Taken.

You took 2 damage from the calamity. Your current health is 118.

>eat apple
(first taking the Apple)
You took 2 damage from the calamity. Your current health is 98.

>eat apple
(first taking the Apple)
You took 2 damage from the calamity. Your current health is 98.

* * *

>w
West Passage
A passage on the west side of Hyrule Castle. There is not much here except for a window.

The Northwest Passage is to the northwest. The Guard Chamber is to the west. The Southwest Passage is to the southwest. The Courtyard is to the east.

You can see a Darknut here.

The Darknut stabs you! (Health: 67)

>stab darknut
(with the sharp branch)
You stab the Darknut with your the sharp branch. The Darknut yells out in pain.  (The Darknut's health: 16)

The Darknut stabs you! (Health: 57)

>stab darknut
(with the sharp branch)
You stab the Darknut with your the sharp branch. The Darknut yells out in pain.  (The Darknut's health: 7)

The Darknut stabs you! (Health: 26)

>stab darknut
(with the sharp branch)
With one final thrust of your sharp branch, the Darknut's dead body drops to the ground, dead.

>take sword
Taken.

>drop branch
Dropped.

>w
Guard Chamber
The chamber where the royal guards would spend their breaks.

The West Passage is to the east. The Northwest Passage is to the north. The Southwest Passage is to the south. 

You can see a metal chair, a metal table, and a key-hook (on which is a guard key) here.

You took 2 damage from the calamity. Your current health is 24.

>s
Southwest Passage
A passage on the southwestern side of Hyrule Castle. There is a window on the left side. 

The Guard Chamber is to the north. The Dining Hall is to the south. The South passage is to the southwest. The Kitchen is to the west. The West Passage is to the northeast.

>n
Guard Chamber
The chamber where the royal guards would spend their breaks.

The West Passage is to the east. The Northwest Passage is to the north. The Southwest Passage is to the south. 

You can see a metal chair, a metal table, and a key-hook (on which is a guard key) here.

You took 2 damage from the calamity. Your current health is 22.

>take key
Taken.

You took 2 damage from the calamity. Your current health is 20.

>s
Southwest Passage
A passage on the southwestern side of Hyrule Castle. There is a window on the left side. 

The Guard Chamber is to the north. The Dining Hall is to the south. The South passage is to the southwest. The Kitchen is to the west. The West Passage is to the northeast.

>s
Dining Hall
The room where the royal family would host guests for meals.

The Southwest Passage is to the north. The South passage is to the east.

You can see a Spring Door, a dining table (on which are a fruit bowl (in which are five Apples, five oranges, and five bananas) and a knife), eight chairs, and a sad korok here.

You took 1 damage from the calamity. Your current health is 19.

The korok whimpering.

>take bowl
Taken.

You took 1 damage from the calamity. Your current health is 18.

The korok is moping in the corner.

>give apple to korok
(first taking the Apple)
WOW! Thank you! *chewing noises*
You took 1 damage from the calamity. Your current health is 17.

The korok chews delightedly.

>korok, give me key
(the spring key)
The sad korok gives the spring key to you.

You took 1 damage from the calamity. Your current health is 16.

The korok chews delightedly.

>unlock spring door with spring key
You unlock the Spring Door.

You took 1 damage from the calamity. Your current health is 15.

The korok  is happily eating the food.

>w
(first opening the Spring Door)

Healing Spring
The waters in this pool shimmer with gold.

The Spring Door is to the east.

* * *

>get out
You get out of the pool.

Healing Spring
The waters in this pool shimmer with gold.

The Spring Door is to the east.

>e
Dining Hall
The room where the royal family would host guests for meals.

The Southwest Passage is to the north. The South passage is to the east.

You can see a Spring Door, a dining table (on which is a knife), eight chairs, and a sad korok here.

You took 1 damage from the calamity. Your current health is 149.

The korok  is happily eating the food.

>e
South passage
A passage on the southern side of Hyrule Castle. There is a window and a painting along the south wall. 

The Armory is to the north, through the The Armory Door. The Southwest Passage is to the northwest. The Dining Hall is to the west. The Study is to the east. The East passage is to the northeast.

A fancy red rug.

* * *

>drop rug
Dropped.

>unlock door with armory key
As you unlock the Armory Door, the armory key vanishes

>n
(first opening The Armory Door)

Armory
This room holds the weapons and armor of the Royal Guard. Well, at least it used to...

The South passage is to the south, through the The Armory Door.

You can see a weapon rack (on which are five swords and two bows), a chest (closed), and a Darknut here.

You took 2 damage from the calamity. Your current health is 147.

The Darknut stabs you! (Health: 122)

>stab darknut
What do you want to stab the Darknut with?

>sword
(the broad sword)
You stab the Darknut with your the broad sword. The Darknut yells out in pain.  (The Darknut's health: 8)

You took 2 damage from the calamity. Your current health is 120.

The Darknut stabs you! (Health: 95)

>stab darknut with sword
(the broad sword)
With one final thrust of your broad sword, the Darknut's dead body drops to the ground, dead.

You took 2 damage from the calamity. Your current health is 93.

>open chest
You open the chest, revealing Red Pearl.

You took 2 damage from the calamity. Your current health is 91.

>take pearl
Taken.

You took 2 damage from the calamity. Your current health is 89.

>s
South passage
A passage on the southern side of Hyrule Castle. There is a window and a painting along the south wall. 

The Armory is to the north, through the The Armory Door. The Southwest Passage is to the northwest. The Dining Hall is to the west. The Study is to the east. The East passage is to the northeast.

You can see a red rug here.

>eat apple
(first taking the Apple)
You ate Apple and restored health!

>eat apple
(first taking the Apple)
You ate Apple and restored health!

>e
Study
The room the royal family used when working. 

The Southwest Passage is to the west. The East passage is to the north

You can see a wooden desk (on which are a note and a pen) and a wooden chair here.

You took 1 damage from the calamity. Your current health is 128.

>n
East passage
A passage on the eastern side of Hyrule Castle. There is a window on the right, and a painting to the left.

The Library is to the north. The South passage is to the southwest. The Study is to the south.

A fancy blue rug.

>read painting
A painting depicting a blue goddess bringing law to the newly shaped world. At the top of the painting is a golden triangle adorned with the symbol of Wisdom.

There is a placard at the bottom.

>read placard
The placard reads: "A painting depicting the goddess Nayru bringing law to our world. She is know for her love and embodiment of Wisdom. "

>n
Library
The walls a are lined with books. It seems like it would have been a nice place to relax.

The Royal Chamber is to the north, through the Royal Door. The Courtyard is to the west. The East passage is to the south.

The bookshelf has a large amount of books. Though most of them do not seem interesting.

On the large bookshelf is a blue book (closed).

You can also see a plush chair and a fireplace here.

You took 2 damage from the calamity. Your current health is 126.

>open book
You open the blue book, revealing a royal key.

You took 2 damage from the calamity. Your current health is 124.

>take key
(the royal key)
Taken.

You took 2 damage from the calamity. Your current health is 122.

>unlock royal door with royal key
As you unlock the Royal Door, the  royal key vanishes
You took 2 damage from the calamity. Your current health is 120.

>n
(first opening the Royal Door)

Royal Chamber
The bedroom of the late King and Queen.

The Library is to the south, through the Royal Door.

You can see a Royal bed and an extravagent desk (on which is Nayru's Pearl) here.

You took 1 damage from the calamity. Your current health is 119.

>take pearl
(Nayru's Pearl)
Taken.

You took 1 damage from the calamity. Your current health is 118.

>w
You can't go that way.

You took 1 damage from the calamity. Your current health is 117.

>d
You can't go that way.

You took 1 damage from the calamity. Your current health is 116.

>w
You can't go that way.

You took 1 damage from the calamity. Your current health is 115.

>s
Library
The walls a are lined with books. It seems like it would have been a nice place to relax.

The Royal Chamber is to the north, through the Royal Door. The Courtyard is to the west. The East passage is to the south.

The bookshelf has a large amount of books. Though most of them do not seem interesting.

On the large bookshelf is a blue book (empty).

You can also see a plush chair and a fireplace here.

You took 2 damage from the calamity. Your current health is 113.

>w
Courtyard
The once-beautiful, now calamity stricken courtyard. 

The Sanctum is to the north, through the Grand Entrance. The West Passage is to the west. The Library is to the east.

You can see a Powerful Statue, a Courageous statue, and a Statue of Nayru here.

You took 3 damage from the calamity. Your current health is 110.

>i
You are carrying: 
Nayru's Pearl
Red Pearl
a spring key
a fruit bowl
a guard key
a broad sword
(Health: 110)

You took 3 damage from the calamity. Your current health is 107.

>place red pearl on powerful statue
Red energy emits from Din's Pearl. The statue below has gone from a sickly gray to a brilliant red!
Red Pearl has been placed. You have placed 1 pearls.

You took 3 damage from the calamity. Your current health is 104.

>place blue pearl on wise statue
Blue energy emits from nayru's Pearl. The statue below has gone from a boring gray to a deep blue!
Nayru's Pearl has been placed. You have placed 2 pearls.

You took 3 damage from the calamity. Your current health is 101.

>w
West Passage
A passage on the west side of Hyrule Castle. There is not much here except for a window.

The Northwest Passage is to the northwest. The Guard Chamber is to the west. The Southwest Passage is to the southwest. The Courtyard is to the east.

You can see a sharp branch and a Darknut's dead body here.

>nw
Northwest Passage
A passage on the northwestern side of Hyrule Castle. A large green rug spans this passage. There is a window on the left side, and a painting on the right.

The Lockup is to the north. The Guard Chamber is to the south. The West Passage is to the southeast.

A fancy green rug.

>examine painting and placard
You can't use multiple objects with that verb.

>examine painting
A painting depicting a green goddess creating beings to inhabit the world and breathing life into them. At the top of the painting there is a golden triangle adorned with the green symbol of  Courage. 

There is a placard at the bottom.

>examine placard
The placard reads: "A depiction of the goddess Farore creating the life of this realm. She is known for her liveliness and embodiment of Courage."

>n
Lockup
This is the room where prisoners were kept.

The Northwest Passage is to the south.

You can see four cells (closed and empty), a big cell (closed) (in which is Farore's Pearl), and a Moblin here.

The Moblin stabs you! (Health: 78)

>stab moblin with sword
(the Moblin with the broad sword)
You stab the Moblin with your the broad sword. The Moblin yells out in pain.  (The Moblin's health: 24)

The Moblin stabs you! (Health: 56)

>stab moblin with sword
(the Moblin with the broad sword)
You stab the Moblin with your the broad sword. The Moblin yells out in pain.  (The Moblin's health: 2)

The Moblin stabs you! (Health: 45)

>unlock big cell with guard key
As you unlock the big cell, the guard key vanishes
The Moblin stabs you! (Health: 27)

>open big cell
You open the big cell.

The Moblin stabs you! (Health: 10)

>take pearl
Taken.

The Moblin stabs you with the moblin spear, and you drop to the ground, dead.

    *** You have died. ***

Would you like to RESTART, RESTORE a saved game, QUIT, or UNDO the last command?

>s
Please give one of the answers above.

Would you like to RESTART, RESTORE a saved game, QUIT, or UNDO the last command?

>se
Please give one of the answers above.

Would you like to RESTART, RESTORE a saved game, QUIT, or UNDO the last command?

>e
Please give one of the answers above.

Would you like to RESTART, RESTORE a saved game, QUIT, or UNDO the last command?

>place farore's pearl on statue
Please give one of the answers above.

Would you like to RESTART, RESTORE a saved game, QUIT, or UNDO the last command?

>Farore's statue
Please give one of the answers above.

Would you like to RESTART, RESTORE a saved game, QUIT, or UNDO the last command?

>take sword
Please give one of the answers above.

Would you like to RESTART, RESTORE a saved game, QUIT, or UNDO the last command?

>unlock grand entrance
Please give one of the answers above.

Would you like to RESTART, RESTORE a saved game, QUIT, or UNDO the last command?

>master sword
Please give one of the answers above.

Would you like to RESTART, RESTORE a saved game, QUIT, or UNDO the last command?

>n
Please give one of the answers above.

Would you like to RESTART, RESTORE a saved game, QUIT, or UNDO the last command?

>eat apple
Please give one of the answers above.

Would you like to RESTART, RESTORE a saved game, QUIT, or UNDO the last command?

>i
Please give one of the answers above.

Would you like to RESTART, RESTORE a saved game, QUIT, or UNDO the last command?

>eat banana
Please give one of the answers above.

Would you like to RESTART, RESTORE a saved game, QUIT, or UNDO the last command?

>g
Please give one of the answers above.

Would you like to RESTART, RESTORE a saved game, QUIT, or UNDO the last command?

>g
Please give one of the answers above.

Would you like to RESTART, RESTORE a saved game, QUIT, or UNDO the last command?

>eat orange
Please give one of the answers above.

Would you like to RESTART, RESTORE a saved game, QUIT, or UNDO the last command?

>g
Please give one of the answers above.

Would you like to RESTART, RESTORE a saved game, QUIT, or UNDO the last command?

>stab ganon with master sword
Please give one of the answers above.

Would you like to RESTART, RESTORE a saved game, QUIT, or UNDO the last command?

>stab ganon with master sword
Please give one of the answers above.

Would you like to RESTART, RESTORE a saved game, QUIT, or UNDO the last command?

* * *

>stab darknut
(with the sharp branch)
You stab the Darknut with your the sharp branch. The Darknut yells out in pain.  (The Darknut's health: 16)

The Darknut stabs you! (Health: 57)

>g
(with the sharp branch)
You stab the Darknut with your the sharp branch. The Darknut yells out in pain.  (The Darknut's health: 1)

The Darknut stabs you! (Health: 32)

>g
(with the sharp branch)
With one final thrust of your sharp branch, the Darknut's dead body drops to the ground, dead.

>take sword
Taken.

>w
Guard Chamber
The chamber where the royal guards would spend their breaks.

The West Passage is to the east. The Northwest Passage is to the north. The Southwest Passage is to the south. 

You can see a metal chair, a metal table, and a key-hook (on which is a guard key) here.

You took 2 damage from the calamity. Your current health is 30.

>take key
Taken.

You took 2 damage from the calamity. Your current health is 28.

>s
Southwest Passage
A passage on the southwestern side of Hyrule Castle. There is a window on the left side. 

The Guard Chamber is to the north. The Dining Hall is to the south. The South passage is to the southwest. The Kitchen is to the west. The West Passage is to the northeast.

>s
Dining Hall
The room where the royal family would host guests for meals.

The Southwest Passage is to the north. The South passage is to the east.

You can see a Spring Door, a dining table (on which are a fruit bowl (in which are five Apples, five oranges, and five bananas) and a knife), eight chairs, and a sad korok here.

You took 1 damage from the calamity. Your current health is 27.

The korok whimpering.

>take bowl
Taken.

You took 1 damage from the calamity. Your current health is 26.

The korok whimpering.

>give apple to korok
(first taking the Apple)
WOW! Thank you! *chewing noises*
You took 1 damage from the calamity. Your current health is 27.

The korok gives you a grateful look.

>take key
(the spring key)
That seems to belong to the sad korok.

You took 1 damage from the calamity. Your current health is 26.

The korok gives you a grateful look.

>ask korok to give key
I didn't understand that sentence.

>korok, give me the key
(the spring key)
The sad korok gives the spring key to you.

You took 1 damage from the calamity. Your current health is 25.

The korok gives you a grateful look.

>unlock spring door
What do you want to unlock the Spring Door with?

>spring key
As you unlock the Spring Door, the spring key vanishes
You took 1 damage from the calamity. Your current health is 24.

The korok  is happily eating the food.

>w
(first opening the Spring Door)

Healing Spring
The waters in this pool shimmer with gold.

The Spring Door is to the east.

>enter spring
Dining Hall
The room where the royal family would host guests for meals.

The Southwest Passage is to the north. The South passage is to the east.

You can see a Spring Door, a dining table (on which is a knife), eight chairs, and a sad korok here.

You took 1 damage from the calamity. Your current health is 23.

The korok gives you a grateful look.

>enter pool
You can't see any such thing.

>get out
But you aren't in anything at the moment.

You took 1 damage from the calamity. Your current health is 22.

The korok  is happily eating the food.

>e
South passage
A passage on the southern side of Hyrule Castle. There is a window and a painting along the south wall. 

The Armory is to the north, through the The Armory Door. The Southwest Passage is to the northwest. The Dining Hall is to the west. The Study is to the east. The East passage is to the northeast.

A fancy red rug.

>e
Study
The room the royal family used when working. 

The Southwest Passage is to the west. The East passage is to the north

You can see a wooden desk (on which are a note and a pen) and a wooden chair here.

You took 1 damage from the calamity. Your current health is 21.

>take rug
You can't see any such thing.

>take key
You already have that.

You took 1 damage from the calamity. Your current health is 20.

>drop rug
You can't see any such thing.

>unlock armory door with armory key
You can't see any such thing.

>n
East passage
A passage on the eastern side of Hyrule Castle. There is a window on the right, and a painting to the left.

The Library is to the north. The South passage is to the southwest. The Study is to the south.

A fancy blue rug.

>stab darknut with sword
You can't see any such thing.

>stab darknut with sword
You can't see any such thing.

>take sword
You already have that.

>broad sword
That's not a verb I recognise.

>open chest
You can't see any such thing.

>take pearl
You can't see any such thing.

>s
Study
The room the royal family used when working. 

The Southwest Passage is to the west. The East passage is to the north

You can see a wooden desk (on which are a note and a pen) and a wooden chair here.

You took 1 damage from the calamity. Your current health is 19.

>sw
You can't go that way.

You took 1 damage from the calamity. Your current health is 18.

>ne
You can't go that way.

You took 1 damage from the calamity. Your current health is 17.

>n
East passage
A passage on the eastern side of Hyrule Castle. There is a window on the right, and a painting to the left.

The Library is to the north. The South passage is to the southwest. The Study is to the south.

A fancy blue rug.

>open book
You can't see any such thing.

>take key
You already have that.

>unlock royal door with royal key
You can't see any such thing.

>n
Library
The walls a are lined with books. It seems like it would have been a nice place to relax.

The Royal Chamber is to the north, through the Royal Door. The Courtyard is to the west. The East passage is to the south.

The bookshelf has a large amount of books. Though most of them do not seem interesting.

On the large bookshelf is a blue book (closed).

You can also see a plush chair and a fireplace here.

You took 2 damage from the calamity. Your current health is 15.

>take pearl
You can't see any such thing.

>i
You are carrying: 
a fruit bowl
a guard key
a broad sword
a sharp branch
(Health: 15)

You took 2 damage from the calamity. Your current health is 13.

>s
East passage
A passage on the eastern side of Hyrule Castle. There is a window on the right, and a painting to the left.

The Library is to the north. The South passage is to the southwest. The Study is to the south.

A fancy blue rug.

>w
You can't go that way.

>w
You can't go that way.

>nw
You can't go that way.

>n
Library
The walls a are lined with books. It seems like it would have been a nice place to relax.

The Royal Chamber is to the north, through the Royal Door. The Courtyard is to the west. The East passage is to the south.

The bookshelf has a large amount of books. Though most of them do not seem interesting.

On the large bookshelf is a blue book (closed).

You can also see a plush chair and a fireplace here.

You took 2 damage from the calamity. Your current health is 11.

>stab moblin with sword
You can't see any such thing.

>stab moblin with sword
You can't see any such thing.

>unlock big cell with guard key
You can't see any such thing.

>take pearl
You can't see any such thing.

>s
East passage
A passage on the eastern side of Hyrule Castle. There is a window on the right, and a painting to the left.

The Library is to the north. The South passage is to the southwest. The Study is to the south.

A fancy blue rug.

>se
You can't go that way.

>w
You can't go that way.

>e
You can't go that way.

>e
You can't go that way.

>place red pearl on statue of din
You can't see any such thing.

>place blue pearl on statue of nayru
I didn't understand that sentence.

>place green pearl on statue of courage
You can't see any such thing.

>place green pearl on courageous statue
You can't see any such thing.

>i
You are carrying: 
a fruit bowl
a guard key
a broad sword
a sharp branch
(Health: 11)

>w
You can't go that way.

* * *

>nw
You can't go that way.

>n
Library
The walls a are lined with books. It seems like it would have been a nice place to relax.

The Royal Chamber is to the north, through the Royal Door. The Courtyard is to the west. The East passage is to the south.

The bookshelf has a large amount of books. Though most of them do not seem interesting.

On the large bookshelf is a blue book (closed).

You can also see a plush chair and a fireplace here.

You took 2 damage from the calamity. Your current health is 9.

>open big cell
You can't see any such thing.

>take pearl
You can't see any such thing.

* * *

>se
You can't go that way.

>e
You can't go that way.

>place green pearl on courageous statue
You can't see any such thing.

>take master sword
You can't see any such thing.

>eat apple
(first taking the Apple)
You ate Apple and restored health!

>g
(first taking the Apple)
You ate Apple and restored health!

>g
(first taking the Apple)
You ate Apple and restored health!

>g
You can't see any such thing.

>eat banana
(first taking the banana)
You ate banana and restored health!

>g
(first taking the banana)
You ate banana and restored health!

>g
(first taking the banana)
You ate banana and restored health!

>g
You can't see any such thing.

>eat orange
(first taking the orange)
You ate orange and restored health!

>g
(first taking the orange)
You ate orange and restored health!

>g
(first taking the orange)
You ate orange and restored health!

>g
You can't see any such thing.

>unock grand entrance
That's not a verb I recognise.

>unlock grand entrance with master sword
You can't see any such thing.

>i
You are carrying: 
a fruit bowl
a guard key
a broad sword
a sharp branch
(Health: 100)

>n
Library
The walls a are lined with books. It seems like it would have been a nice place to relax.

The Royal Chamber is to the north, through the Royal Door. The Courtyard is to the west. The East passage is to the south.

The bookshelf has a large amount of books. Though most of them do not seem interesting.

On the large bookshelf is a blue book (closed).

You can also see a plush chair and a fireplace here.

You took 2 damage from the calamity. Your current health is 98.

>stab ganon with master sword
You can't see any such thing.

>stab ganon with master sword
You can't see any such thing.

>stab ganon with master sword
    *** You defeated Ganon and conquered the calamity! ***

Would you like to RESTART, RESTORE a saved game, QUIT, or UNDO the last command?

* * *

>stab ganon with master sword
You can't see any such thing.

>look
Library
The walls a are lined with books. It seems like it would have been a nice place to relax.

The Royal Chamber is to the north, through the Royal Door. The Courtyard is to the west. The East passage is to the south.

The bookshelf has a large amount of books. Though most of them do not seem interesting.

On the large bookshelf is a blue book (closed).

You can also see a plush chair and a fireplace here.

You took 2 damage from the calamity. Your current health is 96.

>i
You are carrying: 
a fruit bowl
a guard key
a broad sword
a sharp branch
(Health: 96)

You took 2 damage from the calamity. Your current health is 94.

* * *

>take bowl
Taken.

You took 1 damage from the calamity. Your current health is 26.

The korok whimpering.

>give korok banana
(first taking the banana)
WOW! Thank you! *chewing noises*
You took 1 damage from the calamity. Your current health is 25.

The korok chews delightedly.

>korok, give me key
(the spring key)
The sad korok gives the spring key to you.

You took 1 damage from the calamity. Your current health is 24.

The korok gives you a grateful look.

>unlokc spring door
That's not a verb I recognise.

>unlock spring door
What do you want to unlock the Spring Door with?

>spring key
As you unlock the Spring Door, the spring key vanishes
You took 1 damage from the calamity. Your current health is 23.

The korok gives you a grateful look.

>go through door
(first opening the Spring Door)

Healing Spring
The waters in this pool shimmer with gold.

The Spring Door is to the east.

>enter pool
The waters of this pool have increased your vitality. Your maximum health is now 150.
Your health has been restored.

* * *

>take rug
You notice a key was hidden underneath the rug. That does not seem very secure.

>examine key
(the guard key)
You see nothing special about the guard key.

>take key
(the armory key)
Taken.

* * *

>drop rug
Dropped.

>unlock armory door with armory key
As you unlock the Armory Door, the armory key vanishes

>go north
(first opening The Armory Door)

Armory
This room holds the weapons and armor of the Royal Guard. Well, at least it used to...

The South passage is to the south, through the The Armory Door.

You can see a weapon rack (on which are five swords and two bows), a chest (closed), and a Darknut here.

You took 2 damage from the calamity. Your current health is 147.

The Darknut stabs you! (Health: 135)

>stab darknut with sword
(the broad sword)
You stab the Darknut with your the broad sword. The Darknut yells out in pain.  (The Darknut's health: 2)

You took 2 damage from the calamity. Your current health is 133.

The Darknut stabs you! (Health: 105)

>g
(the broad sword)
With one final thrust of your broad sword, the Darknut's dead body drops to the ground, dead.

You took 2 damage from the calamity. Your current health is 103.

>open chest
You open the chest, revealing Red Pearl.

You took 2 damage from the calamity. Your current health is 101.

>take pearl
Taken.

You took 2 damage from the calamity. Your current health is 99.

>s
South passage
A passage on the southern side of Hyrule Castle. There is a window and a painting along the south wall. 

The Armory is to the north, through the The Armory Door. The Southwest Passage is to the northwest. The Dining Hall is to the west. The Study is to the east. The East passage is to the northeast.

You can see a red rug here.

>ne
East passage
A passage on the eastern side of Hyrule Castle. There is a window on the right, and a painting to the left.

The Library is to the north. The South passage is to the southwest. The Study is to the south.

A fancy blue rug.

>n
Library
The walls a are lined with books. It seems like it would have been a nice place to relax.

The Royal Chamber is to the north, through the Royal Door. The Courtyard is to the west. The East passage is to the south.

The bookshelf has a large amount of books. Though most of them do not seem interesting.

On the large bookshelf is a blue book (closed).

You can also see a plush chair and a fireplace here.

You took 2 damage from the calamity. Your current health is 97.

>open book
You open the blue book, revealing a royal key.

You took 2 damage from the calamity. Your current health is 95.

>take key
(the royal key)
Taken.

You took 2 damage from the calamity. Your current health is 93.

>unlock royal door with royal key
As you unlock the Royal Door, the  royal key vanishes
You took 2 damage from the calamity. Your current health is 91.

>n
(first opening the Royal Door)

Royal Chamber
The bedroom of the late King and Queen.

The Library is to the south, through the Royal Door.

You can see a Royal bed and an extravagent desk (on which is Blue Pearl) here.

You took 1 damage from the calamity. Your current health is 90.

>take pearl
(Blue Pearl)
Taken.

You took 1 damage from the calamity. Your current health is 89.

>s
Library
The walls a are lined with books. It seems like it would have been a nice place to relax.

The Royal Chamber is to the north, through the Royal Door. The Courtyard is to the west. The East passage is to the south.

The bookshelf has a large amount of books. Though most of them do not seem interesting.

On the large bookshelf is a blue book (empty).

You can also see a plush chair and a fireplace here.

You took 2 damage from the calamity. Your current health is 87.

>w
Courtyard
The once-beautiful, now calamity stricken courtyard. 

The Sanctum is to the north, through the Grand Entrance. The West Passage is to the west. The Library is to the east.

You can see a Powerful Statue, a Courageous statue, and a Wise statue here.

You took 3 damage from the calamity. Your current health is 84.

>w
West Passage
A passage on the west side of Hyrule Castle. There is not much here except for a window.

The Northwest Passage is to the northwest. The Guard Chamber is to the west. The Southwest Passage is to the southwest. The Courtyard is to the east.

You can see a Darknut's dead body here.

>w
Guard Chamber
The chamber where the royal guards would spend their breaks.

The West Passage is to the east. The Northwest Passage is to the north. The Southwest Passage is to the south. 

You can see a metal chair, a metal table, and a key-hook here.

You took 2 damage from the calamity. Your current health is 82.

>n
Northwest Passage
A passage on the northwestern side of Hyrule Castle. A large green rug spans this passage. There is a window on the left side, and a painting on the right.

The Lockup is to the north. The Guard Chamber is to the south. The West Passage is to the southeast.

A fancy green rug.

>n
Lockup
This is the room where prisoners were kept.

The Northwest Passage is to the south.

You can see four cells (closed and empty), a big cell (closed) (in which is Green Pearl), and a Moblin here.

The Moblin stabs you! (Health: 66)

>stab moblin
What do you want to stab the Moblin with?

>stab moblin with sword
(the Moblin with the broad sword)
You stab the Moblin with your the broad sword. The Moblin yells out in pain.  (The Moblin's health: 24)

The Moblin stabs you! (Health: 42)

>g
(the Moblin with the broad sword)
You stab the Moblin with your the broad sword. The Moblin yells out in pain.  (The Moblin's health: 9)

The Moblin stabs you! (Health: 26)

>g
(the Moblin with the broad sword)
With one final thrust of your broad sword, the Moblin's dead body drops to the ground, dead.

>unlock big cell
What do you want to unlock the big cell with?

>guard key
As you unlock the big cell, the guard key vanishes

>open big cell
You open the big cell.

>take pearl
(Green Pearl)
Taken.

>s
Northwest Passage
A passage on the northwestern side of Hyrule Castle. A large green rug spans this passage. There is a window on the left side, and a painting on the right.

The Lockup is to the north. The Guard Chamber is to the south. The West Passage is to the southeast.

A fancy green rug.

>se
West Passage
A passage on the west side of Hyrule Castle. There is not much here except for a window.

The Northwest Passage is to the northwest. The Guard Chamber is to the west. The Southwest Passage is to the southwest. The Courtyard is to the east.

You can see a Darknut's dead body here.

>e
Courtyard
The once-beautiful, now calamity stricken courtyard. 

The Sanctum is to the north, through the Grand Entrance. The West Passage is to the west. The Library is to the east.

You can see a Powerful Statue, a Courageous statue, and a Wise statue here.

You took 3 damage from the calamity. Your current health is 23.

>place green pearl on statue of farore
Green energy emits from Farore's Pearl. The statue below has gone from a dull gray to a vibrant green!
Green Pearl has been placed. You have placed 1 pearls.

You took 3 damage from the calamity. Your current health is 20.

>place red pearl on statue of din
Red energy emits from Din's Pearl. The statue below has gone from a sickly gray to a brilliant red!
Red Pearl has been placed. You have placed 2 pearls.

You took 3 damage from the calamity. Your current health is 17.

>place blue pearl on statue of nayru
Blue energy emits from nayru's Pearl. The statue below has gone from a boring gray to a deep blue!
Blue Pearl has been placed. You have placed 3 pearls.

You took 3 damage from the calamity. Your current health is 14.

A Blue sword with a winged hilt emerges from the center of the courtyard. You recognize this weapon. The Sword that Seals Darkness.... The Master Sword.

>take sword
(the Master Sword)
Taken.

The Master Sword glows brightly and purifies this location. There is no longer calamity in this location.

>n
(first opening the Grand Entrance)
It seems to be locked.

>unlock grand entrance with master sword
You unlock the Grand Entrance.

>n
(first opening the Grand Entrance)
"You made a mistake by coming here Hero. "

You hear the Grand Entrance close behind you...

"You may have the sword, but you are weak!"

Ganon stabs you with the broad sword, and you drop to the ground, dead.

    *** You have died. ***

Would you like to RESTART, RESTORE a saved game, QUIT, or UNDO the last command?

* * *

After a long and grueling battle against the calamity, you find yourself in the courtyard of Hyrule Castle. The calamity has corrupted this land and its influence can be battled with objects of great power. Find the pearls of the goddesses that have been scattered throughout Hyrule Castle and return them to the statues before your time runs out.

Hyrule Castle
An Interactive Fiction by Joe DeLuca
Release 1 / Serial number 190324 / Inform 7 build 6M62 (I6/v6.33 lib 6/12N) SD

North Side
You can see Gohma here.

>take sharp branch
Taken.

You took 3 damage from the calamity. Your current health is 97.

>go west
West Passage
A passage on the west side of Hyrule Castle. There is not much here except for a window.

The Northwest Passage is to the northwest. The Guard Chamber is to the west. The Southwest Passage is to the southwest. The Courtyard is to the east.

You can see a Darknut here.

The Darknut stabs you! (Health: 81)

>stab darknut with branch
(the Darknut with the sharp branch)
You stab the Darknut with your the sharp branch. The Darknut yells out in pain.  (The Darknut's health: 20)

The Darknut stabs you! (Health: 61)

>stab darknut with branch
(the Darknut with the sharp branch)
You stab the Darknut with your the sharp branch. The Darknut yells out in pain.  (The Darknut's health: 10)

The Darknut stabs you! (Health: 37)

>stab darknut with branch
(the Darknut with the sharp branch)
With one final thrust of your sharp branch, the Darknut's dead body drops to the ground, dead.

>w
Guard Chamber
The chamber where the royal guards would spend their breaks.

The West Passage is to the east. The Northwest Passage is to the north. The Southwest Passage is to the south. 

You can see a metal chair, a metal table, and a key-hook (on which is a guard key) here.

You took 2 damage from the calamity. Your current health is 35.

>take key
Taken.

You took 2 damage from the calamity. Your current health is 33.

>n
Northwest Passage
A passage on the northwestern side of Hyrule Castle. A large green rug spans this passage. There is a window on the left side, and a painting on the right.

The Lockup is to the north. The Guard Chamber is to the south. The West Passage is to the southeast.

A fancy green rug.

* * *

>read placard
The placard reads: "A depiction of the goddess Farore creating the life of this realm. She is known for her liveliness and embodiment of Courage."

>n
Lockup
This is the room where prisoners were kept.

The Northwest Passage is to the south.

You can see four cells (closed and empty), a big cell (closed) (in which is Farore's Pearl), and a Moblin here.

The Moblin stabs you! (Health: 8)

>stab moblin
What do you want to stab the Moblin with?

>stab moblin with sharp branch
(the Moblin with the sharp branch)
You stab the Moblin with your the sharp branch. The Moblin yells out in pain.  (The Moblin's health: 37)

The Moblin stabs you with the moblin spear, and you drop to the ground, dead.

    *** You have died. ***

Would you like to RESTART, RESTORE a saved game, QUIT, or UNDO the last command?

* * *

After a long and grueling battle against the calamity, you find yourself in the courtyard of Hyrule Castle. The calamity has corrupted this land and its influence can be battled with objects of great power. Find the pearls of the goddesses that have been scattered throughout Hyrule Castle and return them to the statues before your time runs out.

Hyrule Castle
An Interactive Fiction by Joe DeLuca
Release 1 / Serial number 190324 / Inform 7 build 6M62 (I6/v6.33 lib 6/12N) SD

North Side
You can see Gohma here.

>examine gohma
(Gohma)
You see nothing special about Gohma.

(Health: 300)

>take eye from gohma
That seems to belong to Gohma.

>i
You don't seem to have anything now.
(Health: 100)

>stab gohma
(with Gohma)
You need a bladed weapon to stab anything.

* * *

>examine gohma
(Gohma)
You see nothing special about Gohma.

(Health: 300)

>stab gohma with broad sword
You stab Gohma with your the broad sword. Gohma yells out in pain.  (Gohma's health: 286)

Gohma stabs you! (Health: 79)

>stab gohma with broad sword
You stab Gohma with your the broad sword. Gohma yells out in pain.  (Gohma's health: 264)

Gohma stabs you! (Health: 64)

>stab gohma with broad sword
You stab Gohma with your the broad sword. Gohma yells out in pain.  (Gohma's health: 235)

Gohma stabs you! (Health: 47)

>stab gohma with broad sword
You stab Gohma with your the broad sword. Gohma yells out in pain.  (Gohma's health: 220)

Gohma stabs you! (Health: 30)

>stab gohma with broad sword
You stab Gohma with your the broad sword. Gohma yells out in pain.  (Gohma's health: 203)

Gohma stabs you! (Health: 7)

>stab gohma with broad sword
You stab Gohma with your the broad sword. Gohma yells out in pain.  (Gohma's health: 185)

Gohma stabs you with the Mandibles, and you drop to the ground, dead.

    *** You have died. ***

Would you like to RESTART, RESTORE a saved game, QUIT, or UNDO the last command?

* * *

>examine gohma
(Gohma)
You see nothing special about Gohma.

(Health: 300)

>stab eye with broad sword
SHREEEIEEIIEIEIEIEIEIEIEIIEIELK!
You have stabbed gohma in the eye!

>stab eye with broad sword
SHREEEIEEIIEIEIEIEIEIEIEIIEIELK!
You have stabbed gohma in the eye!

>stab eye with broad sword
You can't see any such thing.

>examine gohma
Gohma's dead body is a gruesome sight.

>take mandibles
Taken.

>i
You are carrying: 
a Mandibles
a broad sword
(Health: 100)

* * *

After a long and grueling battle against the calamity, you find yourself in the courtyard of Hyrule Castle. The calamity has corrupted this land and its influence can be battled with objects of great power. Find the pearls of the goddesses that have been scattered throughout Hyrule Castle and return them to the statues before your time runs out.

Hyrule Castle
An Interactive Fiction by Joe DeLuca
Release 1 / Serial number 190324 / Inform 7 build 6M62 (I6/v6.33 lib 6/12N) SD

North Side
You can see Gohma here.

>stab eye with broad sword
SHREEEIEEIIEIEIEIEIEIEIEIIEIELK!
You have stabbed gohma in the eye!

I beg your pardon?

>stab eye with broad sword
SHREEEIEEIIEIEIEIEIEIEIEIIEIELK!
You have stabbed gohma in the eye!

>examine gohma
Gohma's dead body is a gruesome sight.

* * *

After a long and grueling battle against the calamity, you find yourself in the courtyard of Hyrule Castle. The calamity has corrupted this land and its influence can be battled with objects of great power. Find the pearls of the goddesses that have been scattered throughout Hyrule Castle and return them to the statues before your time runs out.

Hyrule Castle
An Interactive Fiction by Joe DeLuca
Release 1 / Serial number 190324 / Inform 7 build 6M62 (I6/v6.33 lib 6/12N) SD

North Side
You can see Gohma here.

>stab gohma eye with broad sword
SHREEEIEEIIEIEIEIEIEIEIEIIEIELK!
You have stabbed gohma in the eye!(Gohma's health: 300)

>stab gohma eye with broad sword
SHREEEIEEIIEIEIEIEIEIEIEIIEIELK!
You have stabbed gohma in the eye!(Gohma's health: 200)

>stab gohma eye with broad sword
SHREEEIEEIIEIEIEIEIEIEIEIIEIELK!
You have stabbed gohma in the eye!(Gohma's health: 100)