Beginning Intro.

Please answer the following yes/no questions.

Did you save your friends?

>scene
That's not a verb I recognise.

* * *

Beginning Intro.

Please answer the following yes/no questions.

Did you save your friends?

>look
Atrium

* * *

Beginning Intro.

Please answer the following yes/no questions.

Did you save your friends?

>go south
Attic

>go north
Atrium
You can see Joe here.

>hello joe
That's not a verb I recognise.

>greet joe
That's not a verb I recognise.

>fight joe
Violence isn't the answer to this one.

* * *

Beginning Intro.

Please answer the following yes/no questions.

Did you save your friends?

>y
Did you prove yourself?

>y
Did you help others along your journey?

>y
Selecting Profile 8
Link has 3 heroism
Temple of Time
An Interactive Fiction by Joseph DeLuca
Release 1 / Serial number 190215 / Inform 7 build 6M62 (I6/v6.33 lib 6/12N) SD

Temple of Time

>y
Selecting Profile 16
Time passes.

ProceduralStory
An Interactive Fiction by Joe DeLuca
Release 1 / Serial number 190109 / Inform 7 build 6M62 (I6/v6.33 lib 6/12N) SD

Courtyard
You can see a Boss Door, an Armory Door, a statue of Din, a statue of Farore and a statue of Naryu here.

>wake up
The dreadful truth is, this is not a dream.

Beginning Profile 16

* * *

>y
Selecting Profile 16
Time passes.

ProceduralStory
An Interactive Fiction by Joe DeLuca
Release 1 / Serial number 190109 / Inform 7 build 6M62 (I6/v6.33 lib 6/12N) SD

Courtyard
You can see a Boss Door, an Armory Door, a statue of Din, a statue of Farore and a statue of Naryu here.

>wait
Time passes.

Beginning Profile 16

* * *

>y
Selecting Profile 16
Time passes.

ProceduralStory
An Interactive Fiction by Joe DeLuca
Release 1 / Serial number 190109 / Inform 7 build 6M62 (I6/v6.33 lib 6/12N) SD

Courtyard
You can see a Boss Door, an Armory Door, a statue of Din, a statue of Farore and a statue of Naryu here.

>go east
Library
You can see a King Door, a large bookshelf (on which is a blue book (closed)), a plush chair and a fireplace here.

Beginning Profile 16

>go south
Study
You can see a desk (on which are a note and a pen) and a chair here.

>go west
Dining Hall
You can see a Korok Door and a dining table (on which are a bowl of fruit, eight plates, eight forks, eight spoons and eight kinives) here.

>examine dining table
On the dining table are a bowl of fruit, eight plates, eight forks, eight spoons and eight kinives.

>take chair
You can't see any such thing.

* * *

>y
Selecting Profile 16
Time passes.

ProceduralStory
An Interactive Fiction by Joe DeLuca
Release 1 / Serial number 190109 / Inform 7 build 6M62 (I6/v6.33 lib 6/12N) SD

Courtyard
You can see a Boss Door, an Armory Door, a statue of Din, a statue of Farore and a statue of Naryu here.

I beg your pardon?

I beg your pardon?

>go east
Library
You can see a King Door and a large bookshelf (on which are 100 books and a blue book (in which is a king's key)) here.

Beginning Profile 16

>go south
Study
You can see a desk (on which are a note and a pen) and a chair here.

>go west
Dining Hall
You can see a Korok Door, a dining table (on which are a bowl of fruit, 8 plates, eight forks, 8 spoons and 8 kinives) and 8 chairs here.

>take plate
You can't see any such thing.

>take a plate
You can't see any such thing.

>examine dining table
On the dining table are a bowl of fruit, 8 plates, eight forks, 8 spoons and 8 kinives.

>take bowl of fruit
Taken.

>take 8 plates
Taken.

>inventory
You are carrying:
  8 plates
  a bowl of fruit

>drop plate
You can't see any such thing.

>drop plates
Dropped.

>examine
(the bowl of fruit)
You see nothing special about the bowl of fruit.

>look
Dining Hall
You can see 8 plates, a Korok Door, a dining table (on which are eight forks, 8 spoons and 8 kinives) and 8 chairs here.

>go east
Study
You can see a desk (on which are a note and a pen) and a chair here.

>go north
Library
You can see a King Door and a large bookshelf (on which are 100 books and a blue book (in which is a king's key)) here.

>take book
Taken.

>inventory
You are carrying:
  a blue book
    a king's key
  a bowl of fruit

>take a book
You already have that.

>take 100 books
Taken.

* * *

>y
Selecting Profile 16
Time passes.

ProceduralStory
An Interactive Fiction by Joe DeLuca
Release 1 / Serial number 190109 / Inform 7 build 6M62 (I6/v6.33 lib 6/12N) SD

Courtyard
You can see a Boss Door, an Armory Door, a statue of Din, a statue of Farore and a statue of Naryu here.

>go west
Guard Chamber
You can see a Lockup Door, a metal chair, a metal table and a keyhook (on which is a guard key) here.

Beginning Profile 16

>sit on chair
You get onto the metal chair.

>sit on table
That's not something you can sit down on.

>sit on metal chair
That's not something you can sit down on.

>sit on metal table
That's not something you can sit down on.

* * *

>sit on chair
You get onto the metal chair.

>enter chair
That's not something you can enter.

>fuck
That's not a verb I recognise.

* * *

>sit on chair
You get onto the metal chair.

>exit chair
I only understood you as far as wanting to exit.

>exit metal chair
I only understood you as far as wanting to exit.

>stand
You get off the metal chair.

Guard Chamber
You can see a Lockup Door, a metal chair, a metal table and a keyhook (on which is a guard key) here.

>go south
Dining Hall
You can see a Korok Door, a dining table (on which is a bowl of fruit) and eight wooden chairs here.

>sit on a wooden chair
I only understood you as far as wanting to sit on eight wooden chairs.

>sit on chair
You can't see any such thing.

* * *

>go west
Guard Chamber
You can see a Lockup Door, a metal chair, a metal table and a keyhook (on which is a guard key) here.

Beginning Profile 16

>go south
Dining Hall
You can see a Korok Door, a dining table (on which is a bowl of fruit) and eight chairs here.

>take a chiar
You can't see any such thing.

>take a chair
Taken.

>take chair
Taken.

>take chair
Taken.

>look
Dining Hall
You can see a Korok Door, a dining table (on which is a bowl of fruit) and four chairs here.

>stuff
That's not a verb I recognise.

>inventory
You are carrying:
  four chairs

>drop chairs
chair: Dropped.
chair: Dropped.
chair: Dropped.
chair: Dropped.

* * *

>go west
Guard Chamber
You can see a Lockup Door, a metal chair, a metal table and a keyhook (on which is a guard key) here.

Beginning Profile 16

>take key
Taken.

>go west
(first opening the Lockup Door)
It seems to be locked.

>unlock door
(with the guard key)
You unlock the Lockup Door.

>go west
(first opening the Lockup Door)

Lockup
You can see a Lockup Door and four cells (closed and empty) here.

>check cages
You can't see any such thing.

>take cell
Taken.

>drop cell
Dropped.

>enter a cell
You can't get into the closed cell.

>open cells
You can't use multiple objects with that verb.

>open all cells
You can't use multiple objects with that verb.

>open cell
It seems to be locked.

>unlock cell
(with the guard key)
That doesn't seem to fit the lock.

* * *

>go west
(first opening the Lockup Door)
It seems to be locked.

>unlock lockup door
(with the guard key)
You unlock the Lockup Door.

>go west
(first opening the Lockup Door)

Lockup
You can see a Lockup Door, four cells (closed and empty) and a big cell (closed) (in which is Farore's pearl) here.

>open big cell
It seems to be locked.

>unlock big cell
(with the guard key)
You unlock the big cell.

>take farore's pearl
The big cell isn't open.

>open big cell
You open the big cell.

>take farore's pearl
Taken.

>go east
Guard Chamber
You can see a Lockup Door, a metal chair, a metal table and a keyhook here.

>go east
Courtyard
You can see a Boss Door, an Armory Door, a statue of Din, a statue of Farore and a statue of Naryu here.

>go east
Library
You can see a King Door, a large bookshelf (on which is a blue book (closed)), a plush chair and a fireplace here.

>open blue book
You open the blue book, revealing a king's key.

>take king's key
Taken.

>unlock king door
What do you want to unlock the King Door with?

>king's key
You unlock the King Door.

>go north
(first opening the King Door)

King's Chamber
You can see a King Door, a king's bed and an extravagent desk (on which is Naryu's Pearl) here.

>take naryu's pearl
Taken.

>go south
Library
You can see a King Door, a large bookshelf (on which is a blue book (empty)), a plush chair and a fireplace here.

>go east
You can't go that way.

>unlock Armrory door
You can't see any such thing.

>unlock armory door with guard key
You can't see any such thing.

>go east
You can't go that way.

>look
Library
You can see a King Door, a large bookshelf (on which is a blue book (empty)), a plush chair and a fireplace here.

>go west
Courtyard
You can see a Boss Door, an Armory Door, a statue of Din, a statue of Farore and a statue of Naryu here.

>unlock armory door with guard key
You unlock the Armory Door.

>go south
(first opening the Armory Door)

Armory
You can see an Armory Door, a weapon rack (on which are five swords and two bows) and a chest (closed) here.

>open chest
You open the chest, revealing Din's Pearl.

>take Din's pearl
Taken.

>go north
Courtyard
You can see an Armory Door, a Boss Door, a statue of Din, a statue of Farore and a statue of Naryu here.

>put din's pearl on din
You put Din's Pearl on the statue of Din.

>put farore pearl on farore
I didn't understand that sentence.

>put farore's pearl on farore
You put Farore's pearl on the statue of Farore.

>put naryu's pearl on naryu
You put Naryu's Pearl on the statue of Naryu.

The Sanctum has opened.

>open boss door
You open the Boss Door.

The Sanctum has opened.

>go north
Sanctum
You can see a Boss Door and a Throne here.

>take throne
Taken.

>eat throne
You eat the Throne. Not bad.

* * *

>take key
Taken.

>go east
Courtyard
You can see a Boss Door, an Armory Door, a statue of Din, a statue of Farore and a statue of Naryu here.

>place key on statue of din
That's not a verb I recognise.

>place key
That's not a verb I recognise.

>put key on statue
Which do you mean, the statue of Din, the statue of Farore or the statue of Naryu?

>the statue of din
Putting things on the statue of Din would achieve nothing.

* * *

>go east
Courtyard
You can see a Boss Door, an Armory Door, a statue of Din, a statue of Farore and a statue of Naryu here.

>put key on statue of din
You put the guard key on the statue of Din.

>look
Courtyard
You can see a Boss Door, an Armory Door, a statue of Din (on which is a guard key), a statue of Farore and a statue of Naryu here.

>take key
Taken.

>open armory door
It seems to be locked.

>unlock armory door
(with the guard key)
You unlock the Armory Door.

>go south
(first opening the Armory Door)

Armory
You can see an Armory Door, a weapon rack (on which are five swords and two bows) and a chest (closed) here.

* * *

>open chest
You open the chest, revealing Din's Pearl.

>take pearl
Taken.

>go north
Courtyard
You can see an Armory Door, a Boss Door, a statue of Din, a statue of Farore and a statue of Naryu here.

>place dins pearl on the statue of din
That's not a verb I recognise.

>put dins pearl on the statue of din
You can't see any such thing.

>put din's pearl on the statue of din
You put Din's Pearl on the statue of Din.

>look
Courtyard
You can see an Armory Door, a Boss Door, a statue of Din (on which is Din's Pearl), a statue of Farore and a statue of Naryu here.

>go east
Library
You can see a King Door, a large bookshelf (on which is a blue book (closed)), a plush chair and a fireplace here.

>take book
Taken.

>open book
You open the blue book, revealing a king's key.

>take king's key
Taken.

>open king door
It seems to be locked.

>unlock door
What do you want to unlock the King Door with?

>king's key
You unlock the King Door.

* * *

>go north
(first opening the King Door)

King's Chamber
You can see a King Door, a king's bed and an extravagent desk (on which is Naryu's Pearl) here.

>take Naryu's Pearl
Taken.

>go south
Library
You can see a King Door, a large bookshelf, a plush chair and a fireplace here.

>go west
Courtyard
You can see an Armory Door, a Boss Door, a statue of Din (on which is Din's Pearl), a statue of Farore and a statue of Naryu here.

>put pearl on the statue of Naryu
(Naryu's Pearl on the statue of Naryu)
You put Naryu's Pearl on the statue of Naryu.

>look
Courtyard
You can see an Armory Door, a Boss Door, a statue of Din (on which is Din's Pearl), a statue of Farore and a statue of Naryu (on which is Naryu's Pearl) here.

>inventory
You are carrying: 
a king's key
a blue book
a guard key
(Health: 100)

>unlock amory door
You can't see any such thing.

>unlock door
Which do you mean, the Armory Door or the Boss Door?

>armory
What do you want to unlock the Armory Door with?

>guard key
That's unlocked at the moment.

>go south
Armory
You can see an Armory Door, a weapon rack (on which are five swords and two bows) and a chest (empty) here.

>take bow
Taken.

>shoot self with bow
*** You have commited suicide! ***

Would you like to RESTART, RESTORE a saved game, QUIT or UNDO the last command?

>UNDO
Armory
[Previous turn undone.]

>look
Armory
You can see an Armory Door, a weapon rack (on which are five swords and a bow) and a chest (empty) here.

>take chest
Taken.

>inventory
You are carrying: 
a chest
a bow
a king's key
a blue book
a guard key
(Health: 100)

>put keys in chest
You can't see any such thing.

>put guard key in chest
You put the guard key into the chest.

>put king's key in chest
You put the king's key into the chest.

>go north
Courtyard
You can see an Armory Door, a Boss Door, a statue of Din (on which is Din's Pearl), a statue of Farore and a statue of Naryu (on which is Naryu's Pearl) here.

>go west
Guard Chamber
You can see a Lockup Door, a metal chair, a metal table and a keyhook here.

>go south
Dining Hall
You can see a Korok Door, a dining table (on which are a bowl of fruit and a knife) and eight chairs here.

>take chair
Taken.

>take chair
You already have that.

>inventory
You are carrying: 
eight chairs
a chest
a bow
a blue book
(Health: 100)

>open chest
That's already open.

>examine chest
In the chest are a king's key and a guard key.

>take key
Which do you mean, the king's key or the guard key?

>king's key
Taken.

>take guard key
Taken.

>close chest
You close the chest.

>inventory
You are carrying: 
a guard key
a king's key
eight chairs
a chest
a bow
a blue book
(Health: 100)

>eat chair
You eat the chair. Not bad.

>eat chair
You eat the chair. Not bad.

>eat chair
You can't see any such thing.

>inventory
You are carrying: 
a guard key
a king's key
a chest
a bow
a blue book
(Health: 100)

>vomit chair
That's not a verb I recognise.

* * *

>take key
Taken.

>unlock
(the guard key with the guard key)
That doesn't seem to be something you can unlock.

>unlock lockup door
(with the guard key)
You unlock the Lockup Door.

>enter lockup door
(first opening the Lockup Door)

Lockup
You can see a Lockup Door, four cells (closed and empty) and a big cell (closed) (in which is Farore's pearl) here.

>take cell
Which do you mean, a cell or the big cell?

>a cell
(the cell)
Taken.

>enter a cell
(the cell)
You can't get into the closed cell.

>open a cell
(the cell)
You open the cell.

>enter a cell
(the cell)
You can only get into something free-standing.

* * *

>go west
Guard Chamber
You can see a Lockup Door, a metal chair, a metal table and a keyhook (on which is a guard key) here.

Beginning Profile 16

>go west
(first opening the Lockup Door)
It seems to be locked.

>take key
Taken.

>unlock door
(with the guard key)
You unlock the Lockup Door.

* * *

>y
Selecting Profile 16
Time passes.

ProceduralStory
An Interactive Fiction by Joe DeLuca
Release 1 / Serial number 190109 / Inform 7 build 6M62 (I6/v6.33 lib 6/12N) SD

Courtyard
You can see a Boss Door, an Armory Door, a statue of Din, a statue of Farore and a statue of Naryu here.

>y
That was a rhetorical question.

Beginning Profile 16

>y
That was a rhetorical question.

>go west
Guard Chamber
You can see a Lockup Door, a metal chair, a metal table and a keyhook (on which is a guard key) here.

>go south
Dining Hall
You can see a Korok Door and a dining table (on which are a bowl of fruit, eight plates, eight forks, eight spoons and 8 kinives) here.

>sit on a chair
You can't see any such thing.

>exit
But you aren't in anything at the moment.

>stand
But you aren't in anything at the moment.

* * *

>y
That was a rhetorical question.

Beginning Profile 16

>take master sword
Taken.

>attack boss door
Violence isn't the answer to this one.

>attack self
Violence isn't the answer to this one.

>stab door
Which do you mean, the Boss Door or the Armory Door?

>stab
(the Master Sword with the Master Sword)
You try to break the blade so that. . . Wait, you can't stab the Master Sword with itself!

>stab self
(with the Master Sword)

    *** You have committed suicide! ***

Would you like to RESTART, RESTORE a saved game, QUIT or UNDO the last command?

* * *

>y
Selecting Profile 16
Time passes.

ProceduralStory
An Interactive Fiction by Joe DeLuca
Release 1 / Serial number 190109 / Inform 7 build 6M62 (I6/v6.33 lib 6/12N) SD

Courtyard
You can see a Boss Door, an Armory Door, a statue of Din, a statue of Farore and a statue of Naryu here.

>eat statue of din
You eat the statue of Din. Not bad.

Beginning Profile 16

>eat boss door
*** Run-time problem P44: Attempt to remove a door from play.

You eat the Boss Door. Not bad.

* * *

>y
Selecting Profile 8
Link has 3 heroism
Temple of Time
An Interactive Fiction by Joseph DeLuca
Release 1 / Serial number 190215 / Inform 7 build 6M62 (I6/v6.33 lib 6/12N) SD

Temple of Time

Please answer yes or no.

>y
Selecting Profile 16
Time passes.

ProceduralStory
An Interactive Fiction by Joe DeLuca
Release 1 / Serial number 190109 / Inform 7 build 6M62 (I6/v6.33 lib 6/12N) SD

Courtyard
You can see a Boss Door, an Armory Door, a statue of Din, a statue of Farore and a statue of Naryu here.

>eat boss door
That's plainly inedible.

Beginning Profile 16

>eat statue of din
That's plainly inedible.

>go west
Guard Chamber
You can see a Lockup Door, a metal chair, a metal table and a keyhook (on which is a guard key) here.

>eat metal chair
That's plainly inedible.

>eat keyhook
That's plainly inedible.

>eat guard key
That's plainly inedible.

* * *

>y
Selecting Profile 8
Link has 3 heroism
Temple of Time
An Interactive Fiction by Joseph DeLuca
Release 1 / Serial number 190215 / Inform 7 build 6M62 (I6/v6.33 lib 6/12N) SD

Temple of Time

>n
North Side
Beginning Profile8.

* * *

>y
Did you help others along your journey?

Please answer yes or no.

>y
Did you defeat the Calamity?

>y
Selecting Profile 16
Time passes.

ProceduralStory
An Interactive Fiction by Joe DeLuca
Release 1 / Serial number 190108 / Inform 7 build 6M62 (I6/v6.33 lib 6/12N) SD

Courtyard
You can see a Boss Door and an Armory Door here.

>go east
Library
You can see a King Door and a large bookshelf (on which are 100 books and a blue book (in which is a king's key)) here.

Beginning Profile 16

>go west
Courtyard
You can see a Boss Door and an Armory Door here.

>go west
Guard Chamber
You can see a Lockup Door, a metal chair, a metal table and a keyhook (on which is ] The guard key) here.

>go south
Dining Hall
You can see a Korok Door and a dining table (on which are a bowl of fruit, 8 plates, eight forks, 8 spoons and 8 kinives) here.

>take a chair
You can't see any such thing.

* * *

>y
Selecting Profile 16
Time passes.

ProceduralStory
An Interactive Fiction by Joe DeLuca
Release 1 / Serial number 190108 / Inform 7 build 6M62 (I6/v6.33 lib 6/12N) SD

Courtyard
You can see a Boss Door and an Armory Door here.

>go west
Guard Chamber
You can see a Lockup Door, an enterable chair, a metal table and a keyhook (on which is a guard key) here.

Beginning Profile 16

>sit on chair
That's not something you can sit down on.

* * *

>y
Did you prove yourself?

>n
Did you help others along your journey?

>y
Selecting Profile 6
Link has 2 heroism
Temple of Time
An Interactive Fiction by Joseph DeLuca
Release 1 / Serial number 190215 / Inform 7 build 6M62 (I6/v6.33 lib 6/12N) SD

Temple of Time

>y
Selecting Profile 14
ProceduralStory
An Interactive Fiction by Joe DeLuca
Release 1 / Serial number 190106 / Inform 7 build 6M62 (I6/v6.33 lib 6/12N) SD

Lockup

>wait
Time passes.

Beginning Profile 14

* * *

>y
Selecting Profile 6
Link has 2 heroism
Temple of Time
An Interactive Fiction by Joseph DeLuca
Release 1 / Serial number 190215 / Inform 7 build 6M62 (I6/v6.33 lib 6/12N) SD

Temple of Time

>n
Selecting Profile 6
Time passes.

ProceduralStory
An Interactive Fiction by Joe DeLuca
Release 1 / Serial number 190109 / Inform 7 build 6M62 (I6/v6.33 lib 6/12N) SD

Courtyard
You can see a Boss Door, an Armory Door and a Master Sword here.

>go left
You can't see any such thing.

>go west
Guard Chamber
You can see a Lockup Door, a metal chair, a metal table and a keyhook (on which is a guard key) here.

Beginning Profile 6

>tke key
That's not a verb I recognise.

>take key
Taken.

>go east
Courtyard
You can see a Boss Door, an Armory Door and a Master Sword here.

>open armory door
It seems to be locked.

* * *

>go south
(first opening the Armory Door)

Armory
You can see an Armory Door, a weapon rack (on which are five swords and two bows) and a chest (closed) here.

>take bow
Taken.

>take sword
Taken.

>take din's pearl
You can't see any such thing.

>shoot self
What do you want to shoot yourself with?

>bow
*** You have commited suicide! ***

Would you like to RESTART, RESTORE a saved game, QUIT or UNDO the last command?

>undo
Armory
[Previous turn undone.]

>inventory
You are carrying: 
a sword
a bow
a guard key
(Health: 100)

>shoot weapon rack
What do you want to shoot the weapon rack with?

>bow
You shoot the weapon rack with your bow. Well, I hope that makes you feel better. Hopefully shooting the weapon rack won't attract any unwanted attention.

>look
Armory
You can see an Armory Door, a weapon rack (on which are four swords and a bow) and a chest (closed) here.

>open chest
You open the chest, revealing Din's Pearl.

>take Din's Pearl
Taken.

* * *

>n
Did you help others along your journey?

>n
Selecting Profile 21
Temple of Time
An Interactive Fiction by Joseph DeLuca
Release 1 / Serial number 190215 / Inform 7 build 6M62 (I6/v6.33 lib 6/12N) SD

Temple of Time

* * *

>y
Did you prove yourself?

Please answer yes or no.

>y
Did you ride a bear?

>y
Did you defeat the Calamity?

Please answer yes or no.

Please answer yes or no.

>y
Selecting Profile 16
Time passes.

ProceduralStory
An Interactive Fiction by Joe DeLuca
Release 1 / Serial number 190108 / Inform 7 build 6M62 (I6/v6.33 lib 6/12N) SD

Courtyard
You can see a Boss Door and an Armory Door here.

>go through armory door
(first opening the Armory Door)
It seems to be locked.

Beginning Profile 16

>go west
Guard Chamber
You can see a Lockup Door and a guard key here.

>take guard key
Taken.

>go right
You can't see any such thing.

>go east
Courtyard
You can see a Boss Door and an Armory Door here.

>open armory door
It seems to be locked.

* * *

>unlock armory door
(with the guard key)
You unlock the Armory Door.

>examine guard key
You see nothing special about the guard key.

>go south
(first opening the Armory Door)

Armory
You can see an Armory Door here.

* * *

>y
Did you defeat the Calamity?

>y
Selecting Profile 16
Time passes.

ProceduralStory
An Interactive Fiction by Joe DeLuca
Release 1 / Serial number 190109 / Inform 7 build 6M62 (I6/v6.33 lib 6/12N) SD

Courtyard
You can see a Boss Door, an Armory Door, a statue of Din, a statue of Farore and a statue of Naryu here.

* * *

I beg your pardon?

>look
Courtyard
You can see a Boss Door, an Armory Door, a statue of Din, a statue of Farore and a statue of Naryu here.

Beginning Profile 16

>take statue
Which do you mean, the statue of Din, the statue of Farore or the statue of Naryu?

>din
That's fixed in place.

* * *

Beginning Intro.

Please answer the following yes/no questions.

Did you save your friends?

>0
Please answer yes or no.

>n
Did you revive your horse when it died?

>n
Did you ride a bear?

>n
Did you defeat the Calamity?

>n
Selecting Profile 1
ProceduralStory
An Interactive Fiction by Joe DeLuca
Release 1 / Serial number 190106 / Inform 7 build 6M62 (I6/v6.33 lib 6/12N) SD

Sanctum

I beg your pardon?

>wait
Time passes.

Beginning Profile1

* * *

Beginning Intro.

Please answer the following yes/no questions.

Did you save your friends?

>n
Did you revive your horse when it died?

* * *

>n
Did you defeat the Calamity?

>n
Selecting Profile 1
Time passes.

ProceduralStory
An Interactive Fiction by Joe DeLuca
Release 1 / Serial number 190108 / Inform 7 build 6M62 (I6/v6.33 lib 6/12N) SD

Courtyard
You can see a Boss Door and an Armory Door here.

>wait
Time passes.

Beginning Profile1

* * *

>n
Selecting Profile 1
Time passes.

ProceduralStory
An Interactive Fiction by Joe DeLuca
Release 1 / Serial number 190108 / Inform 7 build 6M62 (I6/v6.33 lib 6/12N) SD

Courtyard
You can see a Boss Door and an Armory Door here.

>go north
You can't go that way.

Beginning Profile1

>ls
That's not a verb I recognise.

>look
Sanctum

* * *

>n
Selecting Profile 1
Time passes.

ProceduralStory
An Interactive Fiction by Joe DeLuca
Release 1 / Serial number 190108 / Inform 7 build 6M62 (I6/v6.33 lib 6/12N) SD

Courtyard
You can see a Boss Door and an Armory Door here.

>go west
Guard Chamber
You can see a Lockup Door, a metal chair, a metal table and a keyhook (on which is ] The guard key) here.

Beginning Profile 1

>go south
Dining Hall
You can see a Korok Door, a dining table (on which is a bowl of fruit) and 8 chairs here.

>take a chair
You can't see any such thing.

>take chair
You can't see any such thing.

>examine 8 chairs
You see nothing special about 8 chairs.

* * *

>n
Selecting Profile 1
Time passes.

ProceduralStory
An Interactive Fiction by Joe DeLuca
Release 1 / Serial number 190108 / Inform 7 build 6M62 (I6/v6.33 lib 6/12N) SD

Courtyard
You can see a Boss Door and an Armory Door here.

>go east
Study
Beginning Profile1

>look
Study

* * *

>go east
Study
Beginning Profile1

>wait
Time passes.

* * *

>n
Selecting Profile 1
Time passes.

ProceduralStory
An Interactive Fiction by Joe DeLuca
Release 1 / Serial number 190108 / Inform 7 build 6M62 (I6/v6.33 lib 6/12N) SD

Courtyard
You can see a Boss Door and an Armory Door here.

>sleep
You aren't feeling especially drowsy.

Beginning Profile 1

>wake up
The dreadful truth is, this is not a dream.

* * *

Beginning Intro.

Please answer the following yes/no questions.

Did you save your friends?

>no
Did you revive your horse when it died?

>no
Did you ride a bear?

>no
Did you defeat the Calamity?

>no
Selecting Profile 1
ProceduralStory
An Interactive Fiction by Joe DeLuca
Release 1 / Serial number 190107 / Inform 7 build 6M62 (I6/v6.33 lib 6/12N) SD

Courtyard
You can see a Boss Door here.

>wait
Time passes.

Beginning Profile 1

* * *

Beginning Intro.

Please answer the following yes/no questions.

Did you save your friends?

>ye
Please answer yes or no.

>y
Did you revive your horse when it died?

>y
Did you ride a bear?

* * *

>y
Did you defeat the Calamity?

>y
Selecting Profile 16
ProceduralStory
An Interactive Fiction by Joe DeLuca
Release 1 / Serial number 190107 / Inform 7 build 6M62 (I6/v6.33 lib 6/12N) SD

Courtyard
You can see a Boss Door here.

>wait
Time passes.

Beginning Profile 16

* * *

Beginning Intro.

Please answer the following yes/no questions.

Did you save your friends?

>up
Bell Tower

>u
Roof

>u
You can't go that way.

>w
West Side

>u
Roof

>w
West Side

>n
North Side

>e
East Side

>s
South Side

>w
West Side

* * *

>n
North Side

>s
Temple of Time

>s
South Side

* * *

Beginning Intro.

Please answer the following yes/no questions.

Did you save your friends?

>yes
Did you prove yourself?

>yes
Did you help others along your journey?

>yes
Selecting Profile 8
Temple of Time
An Interactive Fiction by Joseph DeLuca
Release 1 / Serial number 190215 / Inform 7 build 6M62 (I6/v6.33 lib 6/12N) SD

Temple of Time

* * *

Beginning Intro.

Please answer the following yes/no questions.

Did you save your friends?

>yyyy
Please answer yes or no.

>y
Did you prove yourself?

* * *

>y
Did you help others along your journey?

>y
Selecting Profile 8
Link has 3 heroism
Temple of Time
An Interactive Fiction by Joseph DeLuca
Release 1 / Serial number 190313 / Inform 7 build 6M62 (I6/v6.33 lib 6/12N) SD

Temple of Time